f271;f301;f311;f321;f331;f171;f181;f191;f201;f211;f221;f231;f121;f131;f141;f151;f261;f251;sez;key
17498;0;0;2326;0;1203;40;0;1436;590;71;2097;100;73;5;178;52;26;N;104322
23605;0;20355;3250;0;1602;0;0;1720;278;75;2073;153;10;0;163;52;35;C;27483
19295;0;0;1919;0;1504;0;171;1686;257;1;1944;159;0;0;159;52;28;Q;57369
22763;0;0;1481;0;2301;0;0;1648;848;0;2496;160;8;0;168;52;20;C;14549
13528;50;0;2094;0;1592;90;0;1174;90;87;1351;168;0;4;172;40;11;C;115531
13169;0;0;0;0;1113;0;0;2472;24;0;2496;176;0;0;176;52;3;S;27430
20980;0;0;2306;0;1570;0;0;1547;528;9;2084;139;29;0;168;52;40;C;32868
28421;0;0;4688;0;1902;0;0;1674;368;35;2077;155;17;0;172;52;23;M;113496
26935;0;0;2892;0;1991;28;0;1772;308;24;2104;164;4;2;170;52;31;C;62744
38476;0;0;5497;0;2748;0;0;1508;348;0;1856;149;4;0;153;48;25;K;125251
18128;0;0;1554;0;1536;106;0;1817;136;218;2171;167;0;11;178;52;17;H;169211
20839;0;0;2776;0;1407;10;0;1705;222;111;2038;127;38;1;166;52;24;G;95280
9441;0;0;678;0;1357;0;0;911;40;0;951;168;0;0;168;27;15;G;18020
27292;1329;0;3703;0;2145;0;0;1561;336;0;1897;163;0;0;163;52;18;K;112316
31885;0;0;1961;0;1961;0;0;0;1635;0;1635;157;11;0;168;52;36;J;30756
18651;0;0;5352;0;3729;0;0;1728;304;0;2032;176;0;0;176;42;91;C;101854
50135;0;0;4788;0;3408;180;1030;1213;232;189;1634;104;0;8;112;52;25;D;59014
28606;0;0;4373;0;1939;0;0;1732;316;21;2069;143;33;0;176;52;21;G;145680
18581;0;0;1559;0;1559;0;0;1764;0;0;1764;173;0;0;173;52;24;C;162140
38596;0;0;4295;0;2401;0;0;1840;192;0;2032;168;0;0;168;52;13;C;44312
26294;0;0;1936;0;2012;0;0;1309;428;0;1737;124;0;0;124;52;43;C;26370
24281;0;0;1920;0;1832;0;0;1448;534;18;2000;150;2;0;152;52;30;C;34096
373200;136;0;51688;0;26339;0;0;2032;264;0;2296;168;0;0;168;52;26;J;178716
16760;0;0;321;0;1507;66;153;541;1;60;602;177;0;7;184;13;1;R;61626
16835;0;0;1060;0;1243;0;0;1364;190;0;1554;112;56;0;168;52;17;C;173133
25098;0;0;1917;0;1917;0;0;1220;0;0;1220;120;0;0;120;52;5;C;59078
46507;1160;0;9136;0;3077;0;0;1669;337;0;2006;142;7;0;149;52;27;K;86857
25803;0;0;1;0;2815;0;0;1872;0;332;2204;156;0;0;156;52;30;Q;92964
51423;0;1060;8042;0;3506;118;0;1513;347;117;1977;128;27;0;155;52;21;C;176361
21631;0;0;1555;0;1858;137;0;1719;313;85;2117;152;8;22;182;52;33;J;88282
17045;0;0;1369;0;1218;0;0;1814;321;0;2135;163;5;0;168;52;17;C;25966
26917;0;0;3554;0;1803;0;0;1924;0;0;1924;168;0;0;168;52;26;G;113568
44129;0;0;3331;0;3460;0;0;1608;300;0;1908;150;8;0;158;52;25;K;12629
42156;0;0;9192;0;3235;90;0;1602;7;99;1708;142;0;6;148;52;25;K;62347
22947;0;0;1630;0;1762;134;0;1958;230;87;2275;168;0;10;178;52;17;C;35322
46620;0;0;6015;0;1840;13;0;1893;195;250;2338;168;0;1;169;52;18;C;156252
28147;0;0;3486;0;1858;0;25;1825;349;0;2174;139;33;0;172;52;21;H;173390
44964;0;1628;5259;0;3196;0;0;1523;509;0;2032;154;22;0;176;52;35;M;70334
27097;0;0;2279;0;3031;0;0;1502;508;34;2044;149;16;10;175;52;33;M;172105
18521;0;16868;1653;0;2450;735;0;1144;600;343;2087;240;0;72;312;31;75;H;107314
17159;0;0;2714;0;1365;0;0;1835;220;0;2055;153;15;0;168;51;18;C;141880
25547;0;1185;216;0;3021;250;308;1553;202;134;1889;168;0;21;189;41;25;C;142755
23874;0;0;3354;0;1845;7;0;1723;200;51;1974;119;40;1;160;52;25;M;150154
21442;0;0;3269;0;1587;0;0;NA;NA;NA;NA;NA;NA;0;NA;52;28;G;41553
18761;0;490;1536;0;1705;0;86;1476;591;0;2067;140;20;0;160;46;4;C;90302
28246;0;1855;1855;0;2093;14;0;1225;480;66;1771;117;24;17;158;52;49;Q;103188
22805;0;0;3972;0;1705;0;0;1328;1080;2;2410;131;42;0;173;52;28;C;180392
31850;0;0;2761;0;2111;0;0;1574;204;0;1778;149;0;0;149;52;34;Q;12394
30526;0;0;5396;0;2312;0;0;1402;40;0;1442;142;13;0;155;52;33;I;59189
12108;0;0;839;0;1111;0;0;1831;89;0;1920;168;0;0;168;51;0;C;90609
46094;431;31075;10345;0;2924;75;200;1694;236;38;1968;152;15;0;167;52;30;D;45283
47405;0;0;3380;0;3647;0;0;1577;324;0;1901;168;0;0;168;52;32;Q;185754
24308;0;0;3366;0;1688;0;0;1740;303;0;2043;139;24;0;163;52;14;H;113617
46905;0;0;4401;0;3578;0;0;1361;154;72;1587;127;22;0;149;52;15;D;58999
18240;0;0;2498;0;1282;0;0;2000;43;0;2043;168;0;0;168;52;5;N;91769
21616;0;0;2145;0;2145;0;0;1781;258;0;2039;135;0;0;135;52;14;C;30676
5136;0;0;379;0;1104;0;0;625;28;0;653;160;8;0;168;17;3;C;37056
48113;0;0;6298;0;3149;0;0;2016;0;0;2016;168;24;0;192;52;21;C;103750
16122;0;0;2232;0;951;0;0;1196;24;27;1247;110;0;0;110;52;0;G;159223
22102;0;0;2926;0;1567;81;0;1737;177;136;2050;112;55;8;175;52;28;G;42329
43943;0;0;5684;0;3158;0;0;1780;332;0;2112;148;28;0;176;52;41;H;3914
31192;1874;0;3212;0;1961;240;0;1611;293;23;1927;120;37;15;172;52;179;K;63008
15758;0;0;2260;0;70;0;0;1900;0;0;1900;0;168;0;168;47;9;H;150629
27053;0;1934;2726;0;2093;4;0;1476;492;45;2013;136;24;1;161;52;36;C;120908
35021;0;0;4243;0;2504;0;0;1614;226;0;1840;120;0;0;120;52;30;C;113915
60088;0;0;11051;0;3946;0;0;1624;40;0;1664;144;16;0;160;52;50;G;131376
48698;43197;620;4881;0;3631;0;0;1723;365;235;2323;168;0;17;185;52;35;C;33288
44520;0;0;5353;0;3967;1706;0;1785;295;982;3062;168;0;109;277;52;23;C;100511
38393;0;0;5416;0;2714;0;0;1868;163;0;2031;168;0;0;168;52;21;J;114055
23175;0;0;424;0;1944;0;0;1671;298;0;1969;164;3;0;167;52;19;F;6444
25683;0;0;3050;0;2242;178;0;1785;248;176;2209;160;13;15;188;52;26;E;121203
25852;0;23361;2491;0;2263;0;0;1576;247;2;1825;153;0;2;155;52;30;Q;34321
13185;0;307;500;0;2477;225;0;608;1468;72;2148;144;24;16;184;52;1;F;147719
39324;0;5588;13;0;2929;0;50;1833;194;11;2038;168;0;0;168;52;24;C;144339
71613;0;62851;8762;0;4943;0;0;1725;274;21;2020;127;38;4;169;52;35;Q;24374
16907;0;0;1309;0;1435;0;0;1479;204;0;1683;114;30;0;144;52;25;Q;47339
7257;0;0;487;0;1630;0;0;522;174;0;696;155;13;0;168;17;8;F;86843
17587;0;0;1616;0;1356;0;0;1715;373;0;2088;160;8;0;168;52;20;C;61166
40654;1243;0;6740;0;3041;0;0;1627;293;21;1941;157;0;9;166;52;25;N;96574
20061;0;0;1515;0;1523;0;0;1741;227;0;1968;160;0;0;160;52;28;C;66210
86861;486;3840;12638;0;6319;958;0;1734;172;541;2447;142;15;26;183;52;18;J;128167
29455;0;0;3628;0;2280;175;0;1656;350;73;2079;137;34;11;182;52;36;E;133687
26577;0;0;1982;0;2018;0;0;1754;251;0;2005;171;2;0;173;52;22;C;28570
27729;0;1340;3681;0;2243;0;0;1616;328;23;1967;127;30;3;160;52;22;K;103379
33386;0;0;4717;0;2281;0;0;1622;410;0;2032;150;18;0;168;52;42;C;57873
44294;0;0;5246;0;3324;76;0;1521;381;15;1917;119;38;3;160;52;30;K;93313
24182;0;0;1460;0;1963;268;0;1836;252;244;2332;168;0;25;193;52;17;C;149164
30078;0;0;3473;0;2317;0;0;1775;193;105;2073;160;0;8;168;52;17;C;163251
38878;0;0;5554;0;2777;0;0;1718;368;0;2086;160;8;0;168;52;24;J;181451
22326;0;0;2491;0;2374;0;0;1234;368;38;1640;144;32;7;183;50;24;M;33113
20809;0;0;3839;0;1627;0;0;1497;575;0;2072;158;11;0;169;52;36;C;182265
30954;0;407;2807;0;2927;43;265;1536;262;6;1804;138;22;0;160;52;21;Q;161349
36483;0;0;4825;0;2083;0;0;1805;119;0;1924;148;0;0;148;52;16;K;95094
25839;0;1815;1815;0;1908;0;0;1730;310;0;2040;160;8;0;168;52;30;R;25849
27665;0;0;4477;0;1819;105;0;1598;218;118;1934;154;0;14;168;52;29;G;137166
50034;2448;4200;6198;0;3099;0;0;1837;195;0;2032;160;8;0;168;52;17;G;165781
54642;0;0;7068;0;3642;0;0;1860;234;0;2094;160;0;0;160;52;28;N;11565
27344;0;0;2052;0;2052;0;0;1704;416;0;2120;147;21;0;168;52;25;J;56161
45074;0;0;5512;0;2000;0;0;1922;142;0;2064;168;0;0;168;52;18;C;149217
48089;0;0;5603;0;3049;0;0;1712;208;0;1920;160;0;0;160;52;26;K;119062
16051;0;0;1478;0;1406;0;0;1552;257;0;1809;168;0;0;168;47;17;C;38539
28025;0;0;1404;0;2192;0;0;1799;281;650;2730;164;0;0;164;52;26;Q;116519
19893;0;0;1657;0;1397;0;55;1580;145;0;1725;158;10;0;168;52;17;I;17978
22914;0;0;2560;0;1782;0;0;1739;0;120;1859;174;0;0;174;52;22;R;85732
26307;0;24579;1728;0;1857;67;0;1652;282;34;1968;151;0;9;160;52;43;Q;136974
30615;0;0;5803;0;2091;193;0;1657;814;135;2606;155;2;13;170;52;23;G;104156
32764;0;0;4799;0;2237;0;83;1476;348;13;1837;106;50;1;157;52;38;Q;104561
24784;0;2250;1625;0;1904;0;0;1493;177;0;1670;127;38;0;165;52;28;Q;7729
7896;0;0;615;0;2333;0;0;648;32;13;693;168;0;0;168;16;21;G;133215
12054;0;0;1030;0;2078;139;0;794;166;22;982;168;0;9;177;26;19;H;40870
23990;0;0;8334;0;2718;0;0;1749;111;34;1894;133;0;0;133;48;7;C;32873
35077;0;0;2376;0;4427;647;0;1806;331;246;2383;167;1;41;209;52;29;C;9822
20530;0;0;5307;0;1781;0;0;1730;406;0;2136;168;0;0;168;52;29;F;135910
41981;0;0;8823;0;2715;0;0;1570;0;211;1781;151;0;22;173;52;28;M;20266
41818;0;0;7803;0;2767;0;0;1733;336;5;2074;160;8;0;168;52;22;C;118042
39300;0;0;6560;0;2800;0;0;1773;142;0;1915;159;0;0;159;52;19;J;66027
37910;0;0;2;0;2792;0;0;1757;355;0;2112;168;8;0;176;52;33;G;63450
22221;0;0;2993;0;1526;0;0;1877;149;28;2054;170;0;0;170;52;15;H;52854
16097;0;0;941;0;1145;0;0;1793;123;0;1916;146;0;0;146;52;10;H;161532
6580;0;0;0;0;1291;0;0;514;86;0;600;104;0;0;104;20;0;C;26113
4253;0;0;720;0;1990;0;0;480;24;0;504;167;1;0;168;12;0;H;53221
21201;0;0;3042;0;1967;0;0;1904;0;0;1904;143;9;0;152;52;17;D;50419
39015;0;0;378;0;2980;153;0;1711;377;90;2178;144;24;9;177;52;34;C;132739
44090;0;0;2564;0;2503;0;41;1535;245;32;1812;142;14;0;156;52;30;R;183328
41670;0;0;8061;0;2915;0;0;1505;408;0;1913;144;14;8;166;52;27;K;148828
33036;0;0;4477;0;2303;19;0;1660;411;72;2143;126;41;1;168;52;38;C;166113
26600;0;2832;5147;0;1959;21;16;1511;370;13;1894;143;7;2;152;52;27;H;183788
NA;0;0;0;0;NA;0;0;1590;537;0;2127;106;65;0;171;0;39;G;54988
23613;0;0;3486;0;1637;0;0;1829;271;78;2178;139;36;0;175;52;19;M;50373
26118;0;0;3090;0;1967;164;0;1783;249;49;2081;168;0;11;179;52;28;C;159870
8634;0;0;589;0;1356;0;0;791;0;0;791;168;0;0;168;18;0;G;113583
22992;0;0;3340;0;1931;45;0;1760;256;81;2097;160;8;4;172;52;256;C;65121
37061;0;0;5498;0;2426;124;36;1738;183;361;2282;120;38;7;165;52;21;E;397
35980;2291;500;2367;0;2558;0;0;1799;289;10;2098;160;8;0;168;52;21;J;172140
17495;0;0;1457;0;1457;277;0;1506;366;128;2000;130;21;21;172;52;34;R;898
4538;0;0;362;0;1347;114;0;446;104;32;582;145;7;16;168;15;5;Q;146529
23599;0;0;2137;0;2198;150;0;1685;478;55;2218;160;24;8;192;52;39;C;170860
17686;0;0;1483;0;1482;44;0;1760;328;6;2094;168;0;4;172;52;22;C;82991
17082;0;0;2;0;1424;0;0;1468;0;0;1468;160;0;0;160;52;192;C;22005
27467;0;0;3618;0;1857;0;0;1636;365;0;2001;152;7;0;159;52;31;C;71251
17680;0;0;2554;0;1305;0;0;1500;506;90;2096;153;18;0;171;52;26;S;102715
53749;0;0;4946;0;3836;0;0;2016;422;0;2438;176;0;0;176;52;18;C;4952
31171;0;0;2275;0;2725;333;0;1706;270;352;2328;151;9;137;297;49;25;C;130981
22230;0;0;3100;0;1948;0;0;1453;539;39;2031;140;28;0;168;52;30;C;40302
25102;0;650;3620;0;1925;212;0;1636;316;132;2084;152;16;37;205;52;27;C;164617
17724;0;0;2954;0;1477;0;0;1860;60;0;1920;167;7;0;174;52;30;G;105084
34020;0;2873;4037;0;14417;0;0;1277;564;18;1859;136;32;0;168;52;15;C;103436
76719;0;4985;2989;0;5101;0;0;1840;224;0;2064;168;0;0;168;52;19;F;89862
49249;0;0;2781;0;3637;0;0;1781;201;0;1982;157;13;0;170;52;28;Q;18056
29618;0;0;4190;0;1990;0;0;1704;317;20;2041;168;0;0;168;52;34;C;172671
27997;0;0;4469;0;1855;0;0;1824;216;0;2040;168;0;0;168;52;21;B;99557
49805;43742;620;5443;0;3680;0;0;1763;325;61;2149;168;0;5;173;52;33;C;33251
31993;0;0;4072;0;2181;0;0;1609;264;93;1966;148;0;7;155;52;25;K;36049
32454;0;0;3352;0;1676;0;0;1790;448;203;2441;160;8;0;168;52;24;H;88518
33208;0;0;4555;0;2481;253;6;1604;332;16;1952;167;0;0;167;52;37;C;91741
33038;0;0;3685;0;2307;0;0;1487;601;0;2088;131;37;0;168;52;30;C;37324
30303;0;0;5652;0;2267;0;0;1620;413;0;2033;170;3;0;173;52;53;C;144543
54057;934;7418;6529;0;3713;0;0;1768;248;0;2016;145;23;0;168;52;26;H;52941
26458;0;0;1867;0;2197;0;663;1358;378;320;2056;126;0;40;166;52;29;C;134715
NA;0;0;2;0;10;0;0;1920;0;0;1920;160;0;0;160;52;20;N;74076
32269;0;0;5693;0;2215;23;0;1520;598;55;2173;149;18;1;168;52;39;C;119826
31500;0;0;2625;0;2517;0;0;1237;588;217;2042;132;24;0;156;52;44;Q;169422
33599;99;0;3438;0;1829;0;0;1413;206;0;1619;138;10;0;148;52;25;Q;53040
40355;0;0;5222;0;2622;107;0;1639;377;50;2066;168;0;6;174;52;35;J;54590
24494;0;0;2332;0;1796;0;0;1669;423;26;2118;164;4;0;168;52;18;C;95796
32500;0;0;1055;0;2230;0;336;1119;846;40;2005;134;6;0;140;52;23;Q;127762
12302;0;0;1123;0;1830;393;0;711;88;503;1302;196;0;28;224;26;12;H;111217
27714;0;0;1;0;2457;166;0;1736;98;68;1902;171;0;10;181;52;12;F;107083
35463;0;0;3167;0;3258;591;0;1790;242;309;2341;168;0;31;199;52;25;C;3440
20809;0;0;1194;0;1853;0;0;1531;222;0;1753;150;12;0;162;52;28;Q;146018
36565;0;2632;5617;0;2602;46;0;1443;251;35;1729;108;65;2;175;52;30;D;115094
45960;0;0;9709;0;3110;0;0;1584;36;246;1866;137;0;23;160;52;20;M;20279
42773;0;14139;3768;0;2978;0;0;1840;224;0;2064;157;11;0;168;52;19;R;87024
36817;0;1200;3808;0;1879;0;0;2096;311;0;2407;168;40;0;208;52;38;C;102884
39462;1159;0;8518;0;NA;0;0;1756;268;0;2024;160;8;0;168;52;24;K;68619
36884;0;0;5226;0;2592;0;0;1584;252;0;1836;144;7;0;151;52;32;J;31596
15713;0;0;1532;0;1441;0;0;1424;376;0;1800;168;0;0;168;52;22;B;159360
23528;0;0;3394;0;NA;0;0;1696;232;0;1928;124;44;0;168;52;20;C;151935
21695;0;0;2951;0;1804;331;0;1285;755;36;2076;119;49;24;192;52;28;C;141264
23461;0;21379;2082;0;1762;0;0;1366;475;0;1841;116;26;0;142;52;27;Q;75384
37063;0;0;9179;0;2186;30;0;1761;235;42;2038;160;6;2;168;52;28;M;168356
16429;0;0;1451;0;1232;0;232;1544;925;0;2469;160;48;0;208;48;41;C;107548
155922;0;0;10779;0;20033;0;0;1680;0;0;1680;157;0;0;157;52;30;K;119647
40746;3072;0;5382;0;2691;0;0;1726;298;8;2032;168;0;0;168;52;31;M;33756
49727;0;0;7232;0;5089;605;0;1883;296;262;2441;186;4;33;223;52;25;K;69722
93770;0;3000;9160;0;4832;0;0;1780;140;0;1920;160;0;0;160;52;18;K;119072
22680;1368;0;3095;0;1941;0;0;1756;308;0;2064;137;35;0;172;52;47;I;167884
24604;0;14031;3129;0;1717;158;0;1711;268;47;2026;127;30;15;172;52;20;D;39716
21067;0;0;2327;0;1717;0;0;1644;360;0;2004;156;0;0;156;52;30;M;165530
24261;0;0;3663;0;2163;107;501;1461;566;18;2045;163;1;8;172;52;17;C;108221
19634;0;0;1479;0;1479;0;0;2076;0;0;2076;173;0;0;173;52;0;C;12377
35335;0;0;3240;0;2790;164;0;1643;24;207;1874;160;8;19;187;52;20;C;8118
3507;0;0;436;0;1312;0;0;312;0;10;322;163;0;0;163;8;0;H;131028
21356;0;0;4569;0;1734;0;0;1865;137;0;2002;164;0;0;164;52;17;C;121673
23809;0;0;1992;0;1871;0;0;1568;0;0;1568;168;0;0;168;52;37;C;167225
25035;0;0;2114;0;1786;0;0;1689;430;52;2171;104;64;0;168;52;25;C;74225
NA;0;0;0;0;1562;0;0;1461;291;0;1752;120;24;0;144;0;0;C;141119
31937;0;0;4674;0;1950;0;281;1590;312;139;2041;120;48;0;168;52;26;C;177089
18894;0;0;146;0;1591;0;0;612;370;0;982;149;10;0;159;33;10;S;8620
29229;0;0;4716;0;2185;0;97;1980;140;128;2248;165;24;6;195;52;20;G;33403
135416;0;0;1;0;11284;0;0;2028;0;0;2028;169;0;0;169;52;30;R;24172
17380;0;0;4076;0;2245;0;0;1648;136;0;1784;160;0;0;160;47;17;C;104555
32216;0;30373;1843;0;2051;0;72;1338;534;27;1899;102;54;0;156;52;38;S;413
51125;0;0;8563;0;4333;0;0;1630;280;8;1918;172;0;0;172;52;13;C;123942
32812;968;0;9032;0;1925;0;0;1617;233;0;1850;145;8;0;153;52;18;K;127094
20839;0;720;1266;0;1701;0;134;1572;266;0;1838;154;6;0;160;52;26;Q;129272
29477;0;0;2312;0;2530;173;490;1486;439;123;2048;137;20;11;168;52;23;C;154758
79063;76;0;9429;0;5513;0;0;1503;351;0;1854;137;15;0;152;51;31;Q;31684
18973;0;0;2750;0;1359;0;0;1846;253;0;2099;123;39;0;162;52;28;H;106584
16966;0;0;1249;0;1244;0;0;1535;254;0;1789;120;32;0;152;49;19;C;92528
20498;250;0;2124;0;2625;343;0;1149;208;76;1433;148;8;17;173;33;18;C;97438
25524;0;1043;3639;0;1987;70;0;1457;376;10;1843;133;22;7;162;52;26;C;84022
19462;0;0;1471;0;1541;0;0;1801;287;0;2088;160;8;0;168;52;27;C;147050
16916;0;0;1930;0;1321;108;0;1533;361;63;1957;130;17;9;156;50;7;C;58746
24688;0;0;1612;0;2546;0;0;1920;160;0;2080;168;0;0;168;52;20;F;103979
30156;0;0;5026;0;2513;0;0;1319;501;0;1820;139;23;0;162;48;26;E;65351
17934;0;0;3002;0;1511;0;0;1473;248;4;1725;140;28;0;168;47;28;G;167192
26718;0;0;3528;0;1748;0;0;1779;237;0;2016;155;13;0;168;52;25;G;180866
46420;0;0;11280;0;2900;0;0;1920;168;0;2088;168;0;0;168;52;15;R;102123
59057;0;0;13997;0;5002;0;0;1794;182;0;1976;142;22;0;164;52;24;E;24
30367;0;0;3;0;2099;0;0;2048;0;0;2048;168;0;0;168;52;17;H;115489
136703;0;0;15191;0;9452;0;0;1595;298;0;1893;142;18;0;160;52;39;K;125103
38954;0;0;4709;0;2990;285;912;1673;394;198;2265;168;0;19;187;52;29;C;36935
25725;0;0;4019;0;1660;61;0;1790;274;70;2134;152;16;6;174;52;17;G;149354
22916;0;0;2902;0;1678;0;0;1764;264;0;2028;170;8;0;178;52;26;H;11720
25438;0;0;3223;0;1675;31;22;1763;214;255;2232;157;0;8;165;52;23;G;135655
19673;0;0;1513;0;1513;77;0;1743;345;46;2134;168;0;77;245;52;18;C;138939
40852;0;0;1;0;2922;20;0;1720;0;0;1720;361;NA;1;NA;52;27;H;50130
18716;0;0;2536;0;1276;0;0;1885;179;0;2064;166;2;0;168;52;19;G;76845
28392;0;0;2184;0;2184;48;0;1760;183;86;2029;122;51;3;176;52;22;C;16696
29631;0;0;3510;0;1779;410;0;1620;296;332;2248;150;8;30;188;52;25;E;159343
95319;0;73562;21757;0;6098;78;521;1919;285;16;2220;128;38;3;169;52;27;Q;84237
58845;0;0;9253;0;4106;0;0;1664;368;0;2032;168;0;0;168;52;41;C;96153
24649;0;0;1;0;1705;0;0;1760;272;4;2036;173;0;0;173;52;20;J;105165
24599;0;0;3463;0;1740;12;0;1778;262;12;2052;152;16;1;169;52;25;C;166490
72820;0;8856;300;0;5903;0;0;1881;227;0;2108;152;21;0;173;52;20;C;135574
15193;0;0;1201;0;1214;0;50;1293;173;0;1466;142;16;0;158;52;24;Q;4814
27076;0;201;11228;0;2904;392;0;1122;815;52;1989;150;18;28;196;45;30;C;168312
20759;0;0;1939;0;2088;248;0;1387;701;50;2138;160;8;14;182;52;18;C;16984
4734;0;0;762;0;1231;0;0;570;28;0;598;166;2;0;168;14;0;C;52763
25835;295;0;3778;0;1750;0;0;1635;274;9;1918;131;21;0;152;52;21;C;117736
54665;0;0;5720;0;4061;668;6;1774;159;431;2364;179;0;41;220;52;20;H;174626
19620;0;0;3140;0;1356;0;0;1687;330;0;2017;125;40;0;165;52;38;M;112150
25265;0;0;1023;0;1982;49;22;528;1386;76;1990;24;150;3;177;52;27;Q;43680
25340;0;0;1660;0;2647;0;0;1665;137;0;1802;143;7;0;150;52;20;Q;143695
134888;0;0;10071;0;10071;0;0;NA;NA;NA;NA;NA;NA;0;NA;52;15;H;24822
66588;0;0;8247;0;3782;0;0;1617;312;0;1929;133;26;0;159;52;34;M;119945
70482;0;0;4869;0;5362;0;0;1678;239;0;1917;154;5;0;159;52;25;C;140510
42231;0;0;5963;0;2997;0;0;1739;187;0;1926;160;6;0;166;52;30;G;127726
21000;0;0;1577;0;1577;0;0;1750;260;0;2010;126;42;0;168;52;25;J;177905
17957;0;0;1517;0;1517;10;0;1814;228;15;2057;160;4;1;165;48;24;C;50758
84559;0;0;5605;0;6220;0;27;1452;386;531;2369;117;29;0;146;52;43;Q;99021
24070;0;0;1455;0;1985;142;0;1922;328;218;2468;168;0;12;180;52;25;F;56471
19153;20;0;1926;0;2144;285;8;1327;180;56;1563;150;13;19;182;52;14;M;26829
58725;0;0;7784;0;3892;0;0;1748;284;0;2032;168;0;0;168;52;36;C;2616
17086;0;0;165;0;1247;0;0;1471;505;0;1976;124;41;0;165;52;21;S;8622
32847;0;27745;5102;0;2671;0;0;1805;244;0;2049;165;3;0;168;52;24;C;23005
69884;0;0;6381;0;5237;0;0;1622;6;8;1636;152;0;0;152;52;40;Q;155750
4170;0;0;1;0;940;35;0;606;0;26;632;130;0;7;137;52;0;G;163367
30169;0;0;4751;0;2221;78;0;1583;258;6;1847;158;0;5;163;52;24;G;73809
22752;0;0;3973;0;1625;31;0;1710;301;19;2030;159;7;3;169;52;25;G;121715
29200;0;0;4736;0;2038;22;86;1662;132;8;1802;162;0;8;170;52;12;M;124977
27657;0;0;6117;0;1975;0;0;1513;224;0;1737;123;48;0;171;52;13;B;62152
27720;0;0;3068;0;2125;217;0;1725;360;147;2232;182;1;15;198;52;28;C;71205
25884;0;0;2021;0;2031;0;0;1486;538;0;2024;159;9;0;168;52;34;C;39296
27310;0;0;0;0;1986;138;0;1765;396;90;2251;132;36;10;176;52;20;F;107406
19020;0;0;5116;0;1585;0;0;1404;496;0;1900;117;56;0;173;52;29;C;81543
42299;0;0;2959;0;3527;551;171;1341;800;675;2816;102;88;55;245;52;25;H;8940
39783;0;0;3508;0;2062;0;0;1583;282;4;1869;150;2;0;152;52;27;C;175651
36415;0;0;837;0;2812;0;0;1610;302;0;1912;149;8;0;157;52;28;N;179908
39481;0;2474;922;0;2474;210;0;1940;329;181;2450;161;27;15;203;52;13;C;163759
NA;0;999;999;0;NA;0;0;2076;0;0;2076;173;0;0;173;52;20;C;76022
20566;0;0;1524;0;1523;0;0;1640;404;32;2076;144;24;0;168;52;32;C;79189
54624;5130;36475;10323;0;3052;0;0;1686;243;0;1929;150;17;0;167;52;30;M;183054
34200;0;0;1200;0;2665;68;0;1800;48;56;1904;168;0;7;175;48;25;C;148774
23251;0;0;2896;0;1891;266;0;1911;429;104;2444;176;19;29;224;52;30;H;161568
39689;0;0;4333;0;3415;0;0;1688;262;0;1950;134;17;0;151;52;27;G;118133
20496;0;0;2911;0;1466;0;0;1810;2120;0;3930;168;0;0;168;52;28;G;180742
43069;0;0;6357;0;2868;0;0;1748;291;0;2039;164;8;0;172;52;24;C;115246
41874;0;0;3269;0;3269;0;0;1682;238;0;1920;153;7;0;160;52;14;C;172890
33432;0;0;4857;0;2388;0;0;1534;363;0;1897;105;52;0;157;52;31;K;38841
77083;3432;7000;5538;0;5749;0;0;1808;224;0;2032;168;0;0;168;52;27;C;178319
24378;0;0;4743;0;2031;0;0;1479;735;0;2214;115;51;0;166;52;29;C;179191
28200;0;25326;2874;0;2083;0;124;1251;588;15;1854;123;30;0;153;52;34;Q;168907
28200;0;0;4000;0;2120;30;0;1680;270;26;1976;128;38;2;168;52;43;G;7598
27087;0;1325;2903;0;1910;0;0;1757;2;258;2017;156;12;0;168;52;27;C;9625
37079;0;2439;1166;0;2439;0;0;1796;244;0;2040;164;4;0;168;52;31;C;2407
26664;0;24410;1710;0;1972;73;0;1475;339;58;1872;141;7;5;153;52;29;N;33095
19123;0;0;111;0;1655;0;0;1429;631;0;2060;168;0;0;168;52;19;C;100732
NA;0;0;0;0;1440;0;0;NA;NA;NA;NA;170;0;0;170;0;0;C;107438
18196;0;0;1356;0;1416;3;25;1657;259;43;1959;137;30;2;169;52;26;Q;133921
15215;0;0;2305;0;863;0;0;1295;334;0;1629;125;0;0;125;52;31;N;72038
28925;0;0;3712;0;2120;0;256;1737;327;0;2064;172;0;0;172;52;35;I;156889
16979;0;0;1563;0;1725;729;520;1300;0;714;2014;160;0;90;250;35;20;H;52606
52249;1610;0;12728;0;3500;0;0;2260;172;0;2432;208;0;0;208;52;15;S;56368
7349;0;0;576;0;1824;144;0;553;40;12;605;152;16;12;180;17;5;C;58117
27066;0;0;3436;0;1624;224;0;1849;233;155;2237;158;10;23;191;26;12;G;68606
32173;0;0;0;0;1974;0;0;1681;156;250;2087;150;28;0;178;52;21;Q;84577
24138;0;0;3175;0;2067;238;0;1684;384;192;2260;136;32;20;188;52;44;B;105883
29391;0;0;1967;0;2488;0;0;1510;223;0;1733;223;40;0;263;52;27;Q;184698
37221;93;28548;7115;0;2422;44;0;1720;263;60;2043;157;0;2;159;52;24;D;42933
20657;0;0;2561;0;1462;23;0;2141;144;8;2293;195;0;3;198;52;15;G;58344
17096;0;0;1933;0;1435;0;13;1484;591;2;2077;133;40;0;173;52;25;C;148997
41261;0;0;4095;0;3111;0;0;1812;0;0;1812;176;0;0;176;52;35;R;106668
20649;0;0;1386;0;1609;223;0;1770;262;240;2272;156;12;22;190;52;25;C;123769
51013;234;0;8063;0;3544;0;0;1764;348;0;2112;168;0;0;168;52;32;F;168035
69072;0;47044;5407;0;5534;0;0;1555;317;0;1872;130;26;0;156;52;33;Q;131191
27735;219;0;4625;0;1883;38;0;1710;378;45;2133;163;5;3;171;52;28;D;174897
52276;0;0;7470;0;3734;0;0;1452;636;0;2088;168;0;0;168;52;26;G;166350
12530;0;0;2047;0;1762;192;79;909;67;65;1041;154;16;16;186;25;1;C;170211
18266;0;0;2729;0;1377;0;0;1855;212;0;2067;165;7;0;172;49;18;I;74375
29459;0;0;3321;0;2824;206;0;1768;280;188;2236;168;0;15;183;52;21;F;12098
25019;0;0;3972;0;1671;0;0;1751;273;59;2083;152;14;0;166;52;28;C;131745
114835;3593;0;15078;0;7917;0;0;2024;256;0;2280;176;19;0;195;52;25;G;145491
6181;0;0;1840;0;888;0;96;1242;248;0;1490;127;0;0;127;48;17;N;99655
4857;0;0;361;0;1301;0;22;512;8;14;534;168;0;0;168;13;0;C;164788
26400;0;0;3559;0;2063;53;18;2028;0;102;2130;169;0;4;173;52;29;R;24194
23979;0;0;2198;0;1939;0;265;1508;601;0;2109;156;8;0;164;52;38;C;35802
31727;0;0;4532;0;2266;7;0;1380;348;68;1796;116;51;4;171;52;25;C;9905
22971;0;0;2278;0;1609;312;30;2253;287;368;2908;175;0;36;211;52;11;N;147843
44357;0;0;3113;0;3371;0;0;1623;409;0;2032;160;8;0;168;52;31;J;7504
14110;0;0;1175;0;1175;0;0;1796;0;0;1796;160;0;0;160;52;13;Q;55016
NA;0;0;0;0;2754;0;0;NA;NA;NA;NA;168;0;0;168;0;0;C;33981
14039;0;0;958;0;1302;4;20;1496;156;50;1702;163;10;3;176;41;9;J;52782
24698;0;0;1899;0;1899;0;0;1804;272;0;2076;160;0;0;160;52;20;J;14215
40786;0;0;7118;0;3004;0;0;1709;407;134;2250;172;11;15;198;52;42;C;135997
79121;0;0;11303;0;5651;0;0;1780;296;0;2076;173;0;0;173;52;31;M;170319
32918;0;25984;5830;0;2233;30;0;1808;156;27;1991;162;0;2;164;52;17;H;66465
44230;0;0;2741;0;2603;187;351;1443;496;176;2115;113;56;23;192;52;29;C;61885
34254;0;27880;2129;0;2567;0;0;1687;185;0;1872;134;22;0;156;52;25;M;185687
87960;0;0;6036;0;6338;0;0;1936;96;0;2032;168;0;0;168;52;12;C;27171
15644;0;0;3212;0;1582;114;0;1699;134;46;1879;157;20;10;187;52;18;G;79087
20773;0;0;3099;0;1380;19;0;1728;373;101;2202;106;66;8;180;52;50;M;112716
59645;0;0;5606;0;4096;170;0;1711;283;200;2194;164;4;19;187;52;35;C;153862
27094;0;24339;2755;0;2015;429;0;1848;294;440;2582;189;0;42;231;52;17;N;161867
21268;0;1497;2169;0;1674;0;115;1566;235;141;1942;143;30;0;173;52;20;H;95630
25545;0;0;3074;0;1624;75;0;1676;184;54;1914;142;0;7;149;52;18;S;40591
4986;0;0;700;0;2107;0;0;280;76;0;356;152;20;0;172;8;8;N;87051
36333;0;28199;8134;0;2859;0;0;1772;252;0;2024;136;32;0;168;52;29;M;69073
105375;0;0;11798;0;7855;0;0;1651;252;0;1903;157;0;0;157;52;34;K;68661
1410;0;0;13;0;1410;0;0;NA;NA;NA;NA;NA;NA;0;NA;4;15;C;82782
16478;0;0;1902;0;1364;11;0;1464;553;27;2044;160;8;4;172;51;36;C;161681
29194;0;0;7176;0;2258;21;0;1418;614;65;2097;128;40;1;169;52;30;G;57072
39476;129;0;5011;0;3197;0;0;1642;238;0;1880;155;0;0;155;52;32;K;174335
17551;0;0;1252;0;1602;405;0;1632;0;350;1982;136;0;40;176;52;8;Q;16467
37688;0;1793;5677;0;2524;203;0;1608;381;61;2050;154;14;9;177;52;18;C;120083
77893;0;0;18102;0;5110;0;0;1265;287;4;1556;112;8;0;120;52;36;C;174499
38452;0;0;3037;0;2988;0;0;1554;404;0;1958;157;0;0;157;52;35;K;139777
55611;0;0;8039;0;3640;0;0;1580;240;0;1820;135;22;0;157;52;32;K;103682
10049;0;0;1299;0;2109;0;0;974;0;0;974;120;0;0;120;27;10;I;35728
25162;0;0;3923;0;1881;77;0;1791;240;16;2047;152;8;8;168;52;30;C;68210
28493;0;1111;6049;0;1946;0;0;1496;542;58;2096;141;26;0;167;52;30;C;131504
61727;0;55737;5990;0;5043;0;0;1744;243;0;1987;156;0;0;156;52;18;N;85644
31424;0;0;2205;0;2346;0;0;1634;243;40;1917;133;17;0;150;52;30;Q;101460
27498;68;0;4223;0;2477;86;0;1471;538;6;2015;118;50;0;168;52;38;C;5016
97176;0;90524;6652;0;6871;0;0;1542;402;232;2176;136;30;18;184;52;47;Q;174882
32534;0;0;5928;0;2938;0;0;1859;169;0;2028;169;0;0;169;52;26;M;48256
29197;0;0;0;0;2220;0;0;1712;376;0;2088;160;8;0;168;52;32;J;152853
60000;0;0;0;0;4329;0;0;2392;0;0;2392;208;0;0;208;4;13;J;20709
27693;0;0;3564;0;1782;0;0;1743;345;194;2282;157;10;0;167;52;26;G;166355
20996;0;0;2930;0;1508;15;0;1408;500;39;1947;143;11;10;164;52;27;R;21
33662;1332;0;6560;0;2918;196;0;1224;738;11;1973;112;56;9;177;52;32;N;43144
17895;0;0;3076;0;1612;0;0;1826;190;0;2016;171;0;3;174;52;29;G;102152
37534;0;0;4071;0;2983;160;414;1703;227;45;1975;159;1;8;168;52;18;C;58180
30845;0;28393;2153;0;4197;0;298;1472;474;94;2040;149;30;0;179;52;41;Q;169
29503;0;0;4808;0;2072;0;15;1796;253;6;2055;165;7;1;173;52;23;H;175143
5511;0;0;265;0;2380;240;0;312;8;39;359;152;0;19;171;8;0;S;43445
19815;0;0;2746;0;1373;0;0;1791;338;89;2218;169;1;0;170;52;26;N;6846
173258;0;77925;95333;0;20384;150;0;1566;360;127;2053;152;13;5;170;52;37;Q;157510
31769;0;29085;2684;0;2419;0;0;1370;340;0;1710;129;7;0;136;52;36;Q;75436
23760;0;0;3960;0;1980;75;0;1581;279;31;1891;122;30;5;157;52;22;K;12495
72630;0;0;9928;0;4964;0;0;1645;215;0;1860;138;15;0;153;52;28;K;131648
44536;0;2184;3402;0;3608;0;0;1602;144;0;1746;150;0;0;150;52;28;M;185417
20652;0;0;1650;0;1850;0;0;2148;214;0;2362;169;16;0;185;4;32;C;66321
19227;0;0;2484;0;1443;0;0;1713;40;0;1753;153;20;0;173;47;6;I;165190
44418;0;5020;5527;0;3229;0;0;1554;356;0;1910;147;11;0;158;52;24;K;133859
19083;0;0;1505;0;1517;11;0;1816;312;101;2229;160;8;1;169;52;15;C;18858
48734;0;0;3253;0;3599;0;0;1548;532;0;2080;160;8;0;168;52;35;C;65819
6727;0;0;2000;0;1004;0;0;476;1540;0;2016;84;0;0;84;26;42;H;40883
26505;0;0;2333;0;1989;0;0;1638;96;0;1734;152;8;0;160;52;21;C;138642
22387;0;2695;2544;0;NA;0;0;212;1867;1;2080;168;0;0;168;52;4;G;61074
25590;30;0;4747;0;2456;0;0;1443;597;0;2040;168;0;0;168;52;35;M;52444
21072;0;0;1;0;1922;292;0;1549;536;184;2269;159;24;23;206;48;20;F;8901
32400;0;0;500;0;1600;73;0;1760;48;65;1873;48;120;5;173;48;25;C;148773
25872;0;0;2601;0;1950;135;0;1666;422;85;2173;160;8;9;177;52;30;C;98422
12982;0;0;710;0;1737;0;0;1134;83;0;1217;102;71;0;173;29;11;S;164665
26280;0;750;1729;0;1954;325;0;1761;650;334;2745;166;350;290;NA;52;20;C;87114
26813;0;0;3061;0;2114;60;545;1753;275;44;2072;163;0;5;168;52;20;C;49952
25397;0;0;3069;0;2074;0;0;1845;243;0;2088;168;0;0;168;52;20;C;107335
46824;218;0;8665;0;3388;0;0;1620;285;0;1905;157;0;0;157;52;27;K;120537
44000;0;0;0;0;3372;0;0;1872;0;0;1872;172;0;0;172;52;24;M;131400
28868;0;0;6919;0;2221;513;0;1517;499;252;2268;120;48;40;208;52;32;G;84889
51066;0;0;6896;0;4284;0;0;1383;272;0;1655;148;0;0;148;51;22;N;37533
57372;0;0;8196;0;4098;0;0;1814;0;0;1814;136;0;0;136;52;2;G;179014
19681;0;0;3117;0;1728;0;83;1583;320;0;1903;172;0;0;172;52;40;I;122932
23311;0;0;3317;0;1958;0;0;1366;404;0;1770;149;2;0;151;50;17;N;37535
46695;0;0;9369;0;3113;0;0;1256;296;0;1552;168;0;0;168;52;37;C;69567
36369;0;0;1879;0;3079;0;0;1613;282;71;1966;112;36;0;148;52;41;Q;147138
35370;0;4881;2;0;2441;100;0;1619;413;46;2078;168;0;6;174;52;33;C;92720
19560;0;0;2482;0;1311;0;0;1781;170;0;1951;159;0;0;159;52;17;K;87128
34768;0;0;5446;0;2273;0;0;1784;248;0;2032;142;26;0;168;52;20;L;19238
38535;0;0;2193;0;3152;314;0;1888;200;236;2324;168;0;21;189;52;18;C;158928
14242;0;0;0;0;1112;0;0;2305;0;0;2305;176;0;0;176;0;24;S;25932
39245;0;0;3233;0;3260;511;0;1666;310;260;2236;200;1;33;234;52;29;C;71207
61961;0;0;2500;0;2776;0;0;1800;150;0;1950;146;0;0;146;52;20;K;29326
22476;0;0;1899;0;1684;0;0;1584;520;1;2105;159;8;0;167;52;37;C;177325
20005;0;0;3150;0;1381;0;0;NA;NA;NA;NA;NA;NA;0;NA;52;28;G;41530
23846;0;0;2095;0;2121;0;251;1223;655;0;1878;139;29;0;168;49;22;C;85441
21486;0;0;2988;0;1396;0;58;1526;410;18;1954;117;10;38;165;52;33;Q;35310
38106;0;0;5131;0;2736;0;0;1440;0;0;1440;132;0;0;132;52;27;H;86339
42966;0;0;3428;0;3354;0;0;1627;453;0;2080;144;24;0;168;52;17;C;66896
49117;0;0;7329;0;3174;0;0;1462;180;114;1756;151;0;20;171;52;19;M;20277
43769;0;0;4330;0;3705;0;62;1550;273;61;1884;156;0;6;162;52;45;Q;31966
43000;0;0;2;0;3191;0;0;1872;160;0;2032;168;0;0;168;52;20;R;52984
18883;0;0;1923;0;1682;194;0;1416;360;150;1926;150;0;18;168;52;35;Q;26884
56707;0;0;4647;0;4436;0;0;1607;228;0;1835;127;30;0;157;52;25;K;19850
48006;0;0;6858;0;3429;0;0;NA;NA;NA;NA;NA;NA;0;NA;5;30;G;127325
11087;0;0;100;0;1932;0;0;936;0;0;936;168;0;0;168;25;0;C;76565
21846;0;0;2876;0;1546;99;0;1791;227;89;2107;155;13;10;178;52;21;N;48629
23827;0;0;2994;0;1910;341;0;2006;281;163;2450;180;0;30;210;52;29;R;101965
23693;0;0;2;0;1692;0;0;1314;456;0;1770;103;18;0;121;52;37;H;79410
14984;0;0;1041;0;2500;0;0;772;156;0;928;168;0;0;168;23;0;M;181908
53924;0;0;2500;0;2500;614;0;1759;329;246;2334;143;25;34;202;52;33;G;140332
10835;0;0;366;0;1464;0;0;888;0;0;888;120;0;0;120;19;0;J;18631
NA;0;0;0;0;NA;0;0;1448;136;127;1711;228;16;24;268;0;29;C;59698
10557;0;0;876;0;898;0;0;1504;0;0;1504;144;0;0;144;52;20;C;59457
29064;0;0;5458;0;2135;110;0;1692;281;70;2043;158;6;7;171;52;24;H;69870
NA;0;0;0;0;1454;0;69;NA;NA;NA;NA;168;0;0;168;0;0;G;27207
37871;0;0;4042;0;2870;576;0;1596;471;327;2394;138;30;28;196;52;24;C;97145
31990;0;0;1;0;2945;0;0;1904;0;0;1904;168;0;0;168;48;0;R;71311
29703;0;0;2857;0;2295;0;0;1559;480;0;2039;131;36;0;167;52;60;G;32961
58122;0;6346;2196;0;5164;845;0;1785;296;361;2442;152;16;33;201;52;26;C;84371
27820;0;0;3460;0;2250;674;0;2062;561;275;2898;173;13;37;223;52;30;H;32898
26537;0;0;4182;0;2091;0;0;1772;268;0;2040;151;17;0;168;52;33;K;115315
33979;0;0;5339;0;2340;27;0;1772;216;33;2021;163;0;1;164;52;27;J;106330
14552;0;775;1071;0;1606;16;0;1411;128;154;1693;176;0;16;192;33;13;C;22650
17251;0;0;1427;0;1428;0;0;1800;250;0;2050;168;0;0;168;52;31;C;17398
47021;0;0;9467;0;3525;439;0;1414;568;0;1982;157;0;5;162;52;41;R;33026
35912;0;0;3219;0;2743;0;0;1508;0;0;1508;145;0;0;145;52;25;K;27315
43387;0;0;4835;0;2760;0;0;1663;357;143;2163;164;4;0;168;52;45;C;153866
29128;0;0;5988;0;2219;0;0;1448;592;8;2048;127;41;0;168;52;32;M;115012
27554;0;0;3461;0;2000;221;0;1749;280;189;2218;155;8;16;179;52;38;I;57349
22698;155;0;3969;0;3353;0;0;1232;323;0;1555;146;0;0;146;43;30;E;75889
22425;0;0;3633;0;1471;40;0;1715;222;32;1969;112;36;4;152;52;19;N;59994
28842;0;0;3772;0;2177;83;0;1513;316;27;1856;130;21;5;156;52;22;Q;70668
66718;0;0;4710;0;4711;0;0;1828;204;NA;1624;160;8;0;168;52;21;F;107390
42348;0;1519;3669;0;3228;0;0;1606;300;4;1910;120;38;0;158;52;22;K;12620
26379;0;0;2804;0;3289;188;177;1739;349;182;2270;160;8;14;182;52;20;C;168758
20272;0;0;2896;0;1448;0;0;NA;NA;NA;NA;NA;NA;0;NA;52;33;N;41285
16392;0;0;1246;0;1246;0;0;1631;418;0;2049;160;8;0;168;52;20;C;139298
14567;0;0;1296;0;938;118;126;1736;83;161;1980;156;0;15;171;49;4;H;151886
25545;0;0;2369;0;2141;312;0;1807;361;80;2248;188;5;25;218;52;25;C;106529
20258;0;0;2894;0;1447;0;0;1846;170;0;2016;163;5;0;168;52;13;J;85839
39131;0;0;6588;0;2748;0;0;1394;0;5;1399;101;0;0;101;52;26;K;87651
29200;0;0;3674;0;2038;132;69;2013;251;214;2478;175;2;10;187;52;34;R;10187
36708;0;0;1729;0;8791;0;0;1675;413;0;2088;166;2;0;168;52;18;S;23498
38888;0;1270;2017;0;2413;0;417;1740;330;0;2070;160;8;0;168;52;20;C;62936
20812;0;0;3468;0;1734;0;0;1641;391;150;2182;127;41;0;168;52;42;C;149215
34129;0;0;4684;0;2638;360;0;1600;8;173;1781;160;8;20;188;52;26;C;112717
15871;0;0;1818;0;1420;91;0;1855;93;59;2007;168;0;11;179;51;12;H;52083
38573;0;0;6208;0;2659;66;0;1766;239;39;2044;166;8;3;177;52;23;H;158529
17581;0;0;1203;0;1859;273;0;1692;208;59;1959;146;22;22;190;52;20;B;11609
41564;0;0;3075;0;3110;0;0;1636;126;199;1961;168;0;0;168;52;21;C;89031
16658;0;0;1527;0;1527;0;0;1753;323;0;2076;152;8;0;160;52;28;E;28773
24217;0;0;3460;0;1730;0;0;1848;0;0;1848;168;0;0;168;52;26;Q;17503
28421;0;0;2748;0;2173;103;216;1725;165;29;1919;158;0;8;166;52;20;H;43282
22553;0;0;3221;0;1586;0;0;1746;272;70;2088;142;40;4;186;52;25;G;107013
23000;0;0;5000;0;1500;20;0;1680;190;10;1880;140;10;1;151;52;26;G;154958
32494;0;0;5276;0;2202;0;0;1502;322;3;1827;143;13;0;156;52;33;E;28502
30761;0;0;4409;0;2220;0;0;1669;371;5;2045;160;8;0;168;52;36;J;134146
17363;0;0;2697;0;1311;39;0;1323;777;23;2123;182;0;4;186;52;24;N;184428
23245;0;0;2345;0;1976;930;680;1484;0;819;2303;160;0;90;250;42;20;H;52612
35766;0;0;5109;0;2555;0;0;1304;16;0;1320;168;0;0;168;33;2;H;46706
28656;0;0;1580;0;3330;225;0;1754;278;161;2193;168;0;21;189;52;16;F;86986
26491;0;0;2685;0;1940;48;0;1778;391;18;2187;147;25;4;172;52;22;M;12268
47664;0;0;3548;0;3396;0;0;1601;118;0;1719;152;24;0;176;52;13;M;129065
30332;0;0;3963;0;2197;0;0;1591;485;0;2076;133;40;0;173;52;41;C;181057
23284;0;0;1612;0;2476;0;864;1559;336;0;1895;148;16;0;164;52;23;C;103980
26002;0;0;3131;0;2077;256;0;1885;203;190;2278;156;12;21;189;52;18;C;158205
7179;0;0;490;0;1523;122;0;630;40;12;682;141;24;12;177;18;5;C;58112
44041;1428;35161;8507;0;3214;0;0;1694;185;0;1879;155;0;0;155;52;25;R;74500
19637;0;0;515;0;1801;190;0;1732;368;287;2387;168;0;30;198;48;20;H;83126
43209;1032;0;4781;0;3142;0;0;1482;418;0;1900;120;37;0;157;52;27;K;115874
30961;0;0;6129;0;2014;113;0;1766;265;125;2156;141;26;8;175;52;32;C;49273
18506;0;0;1713;0;1461;0;0;1735;297;0;2032;164;4;0;168;52;20;C;15817
8497;0;0;384;0;1303;190;0;680;40;68;788;168;0;19;187;18;5;N;57723
20042;0;0;2774;0;1499;0;0;1655;0;0;1655;160;13;0;173;52;21;N;86818
24331;922;0;4482;0;1647;0;0;1766;418;0;2184;154;22;0;176;52;30;N;27779
45686;16;12911;5864;0;3340;0;0;1630;252;0;1882;145;10;0;155;52;31;S;75796
26000;0;0;14;0;1540;0;0;1126;860;0;1986;139;26;0;165;52;49;Q;165162
16492;0;0;1101;0;1430;0;0;1492;356;0;1848;164;4;0;168;52;37;C;144786
32159;0;0;3972;0;2390;32;0;1690;398;14;2102;160;8;2;170;52;34;C;172224
NA;0;0;2298;0;2483;0;0;1280;242;131;1653;159;0;11;170;52;22;J;93931
21045;0;0;1710;0;2324;275;0;1395;58;77;1530;168;0;17;185;36;6;C;162274
18626;0;0;1504;0;1402;0;0;1636;396;0;2032;152;16;0;168;52;34;C;14809
10240;0;0;1255;0;NA;0;0;192;1848;0;2040;0;168;0;168;52;1;C;149554
30534;0;0;2;0;2181;0;0;2016;0;0;2016;168;0;0;168;52;20;N;76812
27221;0;96;4502;0;1883;37;58;1649;169;30;1848;106;50;3;159;52;26;E;51982
59678;0;0;5682;0;3717;0;0;1756;268;0;2024;168;0;0;168;52;192;G;181488
30698;0;0;3901;0;2236;13;0;1841;279;2;2122;143;25;1;169;52;17;G;112210
31184;0;0;4695;0;2227;0;0;1576;448;0;2024;152;16;0;168;52;22;H;167080
25144;0;0;0;0;1796;200;0;1920;48;210;2178;160;8;15;183;52;21;C;168624
25340;0;0;2954;0;1886;0;0;1760;328;0;2088;176;0;0;176;52;20;G;174108
22466;0;0;1964;0;1470;0;0;1609;479;0;2088;99;69;0;168;52;37;C;2805
23282;0;0;269;0;1636;0;0;1808;272;0;2080;166;7;0;173;52;27;C;96546
7812;0;0;594;0;1570;0;0;729;145;0;874;176;0;0;176;22;6;Q;138394
30816;0;0;2219;0;2352;0;0;1558;256;65;1879;135;7;0;142;52;38;Q;98990
49212;1135;27974;6403;0;3584;581;613;1534;426;401;2361;139;38;41;218;52;34;D;22477
30369;0;0;3;0;2167;69;0;2048;0;97;2145;168;0;8;176;52;23;H;115479
45928;0;0;3803;0;2369;205;0;1760;229;125;2114;152;11;145;308;52;21;C;110180
66255;0;0;4845;0;5117;0;18;1817;250;1;2068;155;15;0;170;52;24;Q;156050
149818;2519;0;23152;0;10876;0;0;1764;296;0;2060;160;0;0;160;52;37;C;68803
35586;0;0;1861;0;2310;0;0;1632;752;51;2435;143;24;0;167;52;18;C;175302
24474;0;0;1883;0;2309;86;0;1546;519;235;2300;158;10;6;174;52;28;F;8772
17979;0;0;1150;0;1465;0;0;1786;232;27;2045;154;16;0;170;52;16;Q;175022
20258;0;0;1469;0;1455;0;0;1838;194;8;2040;165;2;0;167;52;20;C;90106
58440;0;6000;6595;0;4200;0;0;1745;295;8;2048;112;56;0;168;52;25;H;22073
44911;0;0;3136;0;3548;0;0;1321;351;0;1672;155;5;0;160;52;31;C;91641
156104;0;0;19340;0;9946;0;0;1744;240;0;1984;168;0;0;168;52;30;C;110596
17971;0;0;2395;0;1735;0;0;1472;0;0;1472;144;0;0;144;46;120;F;86067
22829;0;0;1483;0;2613;188;0;1668;363;176;2207;128;39;10;177;52;23;F;72807
11770;0;0;1385;0;1670;10;0;885;100;35;1020;157;17;2;176;26;12;C;134283
12480;0;0;1348;0;NA;0;0;838;439;0;1277;0;168;0;168;52;18;C;85794
34111;0;0;1549;0;2044;155;0;1485;100;80;1665;128;40;0;168;52;19;C;98976
16643;0;0;890;0;1490;0;509;1472;0;7;1479;140;0;0;140;35;15;C;110080
21145;21145;0;3716;0;1870;0;0;1686;394;9;2089;174;0;0;174;52;28;G;7241
39220;0;0;13418;0;2158;0;0;1616;472;16;2104;120;48;0;168;52;32;C;136877
78049;0;0;262;0;5783;0;0;1039;800;0;1839;103;46;0;149;52;43;Q;127772
7940;0;0;485;0;1454;481;0;652;16;102;770;178;20;41;239;15;2;C;123189
14290;0;0;1304;0;1891;324;0;1455;123;68;1646;160;0;25;185;33;7;C;63565
32638;0;0;4291;0;2157;0;0;1686;282;166;2134;131;37;0;168;52;35;E;59762
25000;0;0;1454;0;2395;0;1196;1632;238;16;1886;168;0;0;168;52;12;C;66951
18230;0;0;1317;0;1285;127;0;1800;327;73;2200;120;48;13;181;52;17;C;35735
25518;0;0;2041;0;1859;90;0;1778;171;144;2093;163;8;7;178;52;13;C;39573
24092;0;0;3384;0;1703;0;0;1818;209;18;2045;165;3;0;168;52;15;M;69674
30407;0;0;4154;0;83;0;0;1152;NA;80;NA;0;158;0;158;52;17;C;116298
29618;0;1154;2596;0;2241;0;268;1700;280;24;2004;153;9;0;162;52;24;C;155093
29022;0;0;4388;0;2357;79;0;1693;276;0;1969;157;0;4;161;52;23;C;49361
34126;0;0;2755;0;2784;0;0;1381;374;0;1755;116;36;0;152;52;27;C;128798
19323;0;0;2760;0;1380;11;74;1497;474;7;1978;108;26;7;141;52;26;Q;179777
22355;0;0;3097;0;1557;0;0;1789;199;0;1988;180;0;0;180;52;21;I;161048
17672;0;0;1421;0;1112;0;0;1512;546;0;2058;115;53;0;168;52;22;C;122724
68354;628;3000;6320;0;2631;0;0;1603;176;0;1779;153;0;0;153;52;20;K;137605
23515;0;0;1725;0;2774;474;0;1360;160;88;1608;158;16;30;204;34;20;C;141864
32106;0;2772;3161;0;2116;0;0;1645;180;3;1828;151;0;3;154;52;25;M;184048
27696;0;16456;4138;0;1921;84;0;1728;247;171;2146;159;0;7;166;52;20;D;95157
17785;0;0;1074;0;1131;0;24;1573;145;85;1803;118;0;0;118;52;14;Q;148181
43028;2202;0;8762;0;3370;0;0;1738;298;0;2036;152;16;0;168;52;32;N;70379
18317;0;0;1440;0;3455;0;0;768;56;0;824;168;0;0;168;20;3;E;38808
68658;0;0;9363;0;5884;0;0;1462;289;152;1903;142;8;7;157;52;40;Q;31733
22942;0;0;1516;0;1820;25;0;1896;208;250;2354;168;0;25;193;52;18;C;128448
33342;0;0;7017;0;2196;0;0;1649;328;0;1977;153;0;0;153;52;22;K;81416
27070;0;1080;3671;0;2060;139;99;1871;326;84;2281;167;7;14;188;52;20;N;173263
20425;0;63;1156;0;1734;2;0;1567;505;8;2080;158;1;16;175;52;0;C;110307
21254;0;0;1;0;1441;0;0;1903;173;0;2076;173;0;0;173;52;26;C;131571
16787;0;5139;5139;0;1462;0;0;1756;596;0;2352;120;48;0;168;52;35;C;140751
44800;0;0;8331;0;3006;0;0;1555;426;0;1981;140;24;0;164;52;43;E;61773
29438;0;0;3333;0;2302;0;0;0;1750;329;2079;168;0;0;168;52;25;H;35841
10513;0;0;628;0;1531;15;0;1000;172;20;1192;159;12;15;186;29;13;N;72867
26014;0;0;3811;0;1840;13;0;1644;279;39;1962;136;26;1;163;52;31;H;95588
52461;0;0;7382;0;3691;0;0;1776;152;1;1929;160;8;0;168;52;17;C;116091
14988;0;0;700;0;1249;0;0;2040;0;0;2040;110;60;0;170;52;20;M;138092
31879;0;0;1855;0;2056;0;0;1495;252;61;1808;154;0;0;154;52;24;Q;98943
1212;0;0;13;0;1212;0;0;NA;NA;NA;NA;NA;NA;0;NA;4;20;C;82579
39164;0;0;4674;0;2501;0;0;1584;375;0;1959;135;30;0;165;52;38;C;62851
33171;0;0;3565;0;2385;86;0;1774;257;76;2107;120;48;5;173;52;20;M;162918
24624;0;0;5313;0;2040;13;0;1724;255;29;2008;140;15;1;156;52;22;K;125476
33773;0;0;5513;0;2743;0;323;1549;256;42;1847;128;32;0;160;52;27;C;166671
17009;0;0;1064;0;1856;330;0;1741;152;148;2041;168;0;40;208;52;19;C;150099
104100;0;0;14553;0;7523;0;0;1800;232;0;2032;160;8;0;168;52;26;M;21701
33723;0;6090;3748;0;2732;350;0;1856;184;73;2113;166;2;26;194;52;20;G;23873
189445;180238;0;9207;0;9471;0;0;1785;168;0;1953;147;0;0;147;52;24;M;120663
15274;0;0;1342;0;1342;0;0;1978;108;0;2086;172;0;0;172;51;0;N;76226
24630;1195;579;4829;0;1836;0;0;1551;436;6;1993;124;46;0;170;52;32;H;63100
16774;0;0;2227;0;1198;96;0;1848;207;45;2100;153;15;12;180;52;17;E;67411
23922;0;0;3398;0;2043;0;0;1296;653;8;1957;140;11;0;151;52;24;C;73047
28056;0;0;1885;0;2239;354;0;1780;291;259;2330;160;8;26;194;52;33;G;7014
20538;0;0;3316;0;1577;1;22;1362;702;20;2084;152;20;1;173;52;29;R;70163
13275;0;0;1021;0;1035;0;41;1444;270;0;1714;144;0;0;144;52;27;Q;144593
17560;0;0;1463;0;1505;0;137;1265;715;0;1980;159;6;0;165;52;34;Q;106927
25938;0;21983;3955;0;2221;0;72;1408;85;15;1508;151;6;0;157;52;22;Q;103130
34017;0;0;1;0;3159;217;0;1692;120;149;1961;160;8;16;184;52;2;C;151126
86896;0;0;21588;0;4547;0;0;143;NA;NA;NA;143;0;0;143;52;21;K;32225
50101;0;0;6600;0;3374;0;0;1808;0;0;1808;172;0;0;172;52;10;C;50163
25923;0;21082;1761;0;2232;38;0;1546;273;41;1860;136;14;4;154;52;38;Q;33602
45403;0;0;8635;0;2926;42;0;1735;297;46;2078;146;22;2;170;52;27;C;125187
17046;0;0;1892;0;1435;0;120;1461;615;0;2076;143;30;0;173;52;22;C;148992
53836;0;0;7690;0;3845;1009;0;1589;206;210;2005;143;0;38;181;52;18;L;99918
18297;0;0;4631;0;1218;44;0;1635;501;58;2194;132;40;5;177;52;37;G;89751
73833;0;0;10315;0;5167;0;0;1764;216;0;1980;175;0;0;175;52;25;N;29165
20828;0;0;2796;0;1764;38;0;1605;293;34;1932;163;0;4;167;52;21;C;49949
21738;0;0;1967;0;1817;0;0;1651;124;35;1810;168;0;0;168;52;23;G;173907
28223;0;24387;3836;0;1918;0;0;1903;173;0;2076;163;0;0;163;52;30;R;24206
31359;0;0;3932;0;1988;320;0;1982;86;116;2184;185;2;19;206;52;34;C;42790
32736;0;0;2483;0;2530;0;0;1685;371;0;2056;150;18;0;168;52;36;C;78146
15598;0;0;2188;0;1212;0;0;1342;243;0;1585;146;4;0;150;43;26;K;11085
30286;0;0;3846;0;2054;116;0;1802;285;128;2215;176;0;8;184;52;43;I;44113
35370;526;0;5807;0;2909;0;0;1768;296;0;2064;168;0;0;168;52;33;F;87805
17575;0;300;1487;0;1510;12;0;1140;428;251;1819;108;24;25;157;52;28;Q;15444
53305;0;0;1;0;3928;0;0;2079;0;0;2079;167;0;0;167;52;30;C;10749
25851;0;0;1602;0;1923;0;0;1790;286;15;2091;168;5;0;173;52;18;C;80351
20240;0;0;2021;0;1629;109;0;1663;452;62;2177;144;24;10;178;52;31;C;117012
36828;0;0;4044;0;4146;0;0;1880;364;0;2244;168;40;0;208;52;20;B;135738
41533;0;0;8749;0;2717;0;0;1531;397;143;2071;148;8;0;156;52;30;G;150811
23370;0;0;3895;0;2026;293;0;1999;33;0;2032;210;13;29;252;52;0;H;175612
32381;0;0;3753;0;2409;84;0;1810;302;29;2141;168;0;5;173;52;29;C;79026
23804;0;0;66;0;2439;0;0;1642;0;36;1678;174;0;0;174;52;0;C;141200
52860;0;0;1;0;3733;0;0;1642;0;24;1666;144;0;0;144;52;16;K;96452
31673;0;116;2000;0;2699;168;363;1436;306;87;1829;155;6;11;172;52;35;Q;154825
26467;0;1832;3474;0;1910;0;0;1446;590;0;2036;123;45;0;168;52;40;N;11388
29808;0;0;180;0;2393;0;0;1884;0;0;1884;157;0;0;157;52;10;C;18974
22000;0;0;1500;0;1714;0;0;1910;194;0;2104;168;0;0;168;52;4;C;150599
226864;0;0;18058;0;12619;0;0;1645;260;0;1905;157;0;0;157;52;35;K;4770
34809;0;0;2677;0;2825;0;0;1258;733;0;1991;128;45;0;173;52;23;C;6873
27657;0;0;2127;0;2305;0;0;1584;518;0;2102;159;14;0;173;52;20;C;86795
27962;0;0;2627;0;1981;0;0;1692;112;0;1804;160;8;0;168;49;12;M;69650
26680;0;0;2409;0;2138;0;0;1657;230;0;1887;142;14;0;156;52;32;Q;104790
16771;0;0;55;0;2390;13;0;1243;0;1;1244;172;0;1;173;52;0;C;141194
19850;0;0;2320;0;1275;144;0;1858;230;240;2328;168;0;16;184;52;23;R;102128
NA;0;0;659;0;1798;0;0;0;2088;0;2088;0;168;0;168;52;30;C;140087
3852;0;0;1;0;1242;65;0;522;0;41;563;169;0;13;182;52;0;G;163378
30425;0;0;2272;0;2308;0;0;1560;276;0;1836;114;36;0;150;52;26;Q;169779
32583;0;0;5615;0;2360;26;0;1754;338;10;2102;161;5;4;170;52;25;C;143409
9517;0;6806;560;0;1036;9;0;1270;97;20;1387;166;2;1;169;36;12;S;138639
35759;313;0;5090;0;2556;0;0;1676;261;0;1937;160;8;0;168;52;27;M;182977
15052;0;0;2905;0;1491;0;0;1614;252;20;1886;144;12;0;156;48;37;I;41887
20712;0;0;3252;0;1648;0;0;1726;290;15;2031;109;59;0;168;52;30;G;42408
38404;0;2777;5163;0;2757;0;0;1647;253;6;1906;147;10;0;157;52;21;N;142310
31138;0;0;4330;0;2280;0;0;2076;0;0;2076;173;0;0;173;0;12;F;161482
28196;0;0;422;0;2001;0;0;1608;222;26;1856;123;7;0;130;52;18;C;143330
23033;0;0;3248;0;1624;0;0;1622;488;0;2110;155;7;0;162;52;40;J;153639
80893;0;0;5095;0;5787;0;0;1826;262;0;2088;137;31;0;168;52;20;C;4135
23958;0;0;0;0;1953;0;0;1747;377;0;2124;152;0;0;152;52;18;F;174941
26695;0;21424;5271;0;1856;0;0;1707;325;0;2032;160;8;0;168;52;34;C;39998
40553;0;0;5263;0;2952;425;0;1913;8;133;2054;171;1;21;193;52;19;G;178086
52824;0;0;1800;0;4402;327;0;1870;170;229;2269;168;0;21;189;52;21;N;103088
21532;0;0;3302;0;1666;0;0;1703;0;0;1703;144;24;0;168;52;17;C;28238
21538;0;1366;1366;0;1512;185;0;1865;175;298;2338;157;11;18;186;52;21;C;58062
22519;0;0;1723;0;1723;0;0;1697;335;0;2032;152;16;0;168;52;39;C;158459
126295;0;0;18042;0;9021;0;0;NA;NA;NA;NA;NA;NA;0;NA;5;34;G;127591
16906;0;0;1261;0;1325;0;300;1448;0;306;1754;130;0;27;157;52;22;Q;179657
44;0;0;6;0;NA;0;0;1750;290;0;2040;168;0;0;168;52;36;F;99130
76443;0;7867;8256;0;5254;0;0;1727;361;0;2088;168;0;0;168;52;9;C;180122
21444;0;0;1565;0;1651;0;85;1660;273;0;1933;115;39;0;154;52;32;Q;157850
29895;0;24344;5551;0;2035;0;0;1513;391;2;1906;150;8;0;158;52;21;N;127996
NA;0;0;0;0;1159;41;0;NA;NA;NA;NA;160;8;7;175;0;0;C;16137
37499;0;0;5397;0;2766;0;0;1674;256;0;1930;115;53;0;168;52;28;M;182958
16232;0;0;2079;0;1276;0;0;1407;198;20;1625;156;0;0;156;52;24;C;101706
23215;0;0;1434;0;1528;0;0;1711;330;0;2041;168;0;0;168;52;20;C;67768
35597;0;0;2884;0;2695;0;189;1674;174;0;1848;162;0;0;162;52;29;Q;114332
50220;1416;0;4197;0;3607;0;0;1655;320;0;1975;151;8;0;159;52;38;M;175345
46809;0;0;2627;0;3311;0;0;1763;234;179;2176;107;64;0;171;40;25;D;7866
29712;0;0;3373;0;2263;186;0;1693;323;133;2149;112;56;9;177;52;13;C;5136
25195;0;0;4225;0;2112;0;0;1533;322;0;1855;149;18;0;167;52;23;C;152574
60028;18;2194;6847;0;4161;309;226;1840;359;170;2369;153;37;13;203;52;35;J;105638
25861;0;3676;1957;0;1989;0;0;1780;307;33;2120;162;6;0;168;52;30;C;98810
42500;0;0;1;0;3219;209;0;1792;352;206;2350;120;48;14;182;52;8;F;119845
28568;0;0;2;0;1749;0;0;1492;0;0;1492;113;0;0;113;52;32;H;177024
61317;0;0;4544;0;4810;357;323;1573;365;175;2113;137;23;1;161;52;39;Q;35075
30357;0;0;3102;0;2130;0;1022;1409;435;4;1848;146;15;0;161;52;31;H;162169
22941;0;0;4310;0;1580;97;0;1701;327;90;2118;168;0;8;176;52;22;G;84867
22545;0;0;13;0;1721;0;0;1750;274;40;2064;168;0;0;168;52;20;C;88397
29974;0;0;4754;0;2061;0;0;1710;318;0;2028;136;33;0;169;52;29;M;46968
31509;0;112;3153;0;2397;0;0;1296;462;84;1842;140;18;1;159;52;35;Q;134555
15864;0;0;10;0;1840;0;0;1734;0;0;1734;160;0;0;160;52;0;J;159660
35481;0;4190;4190;0;2775;558;423;1728;192;286;2206;160;8;38;206;52;15;E;179569
37107;0;0;5026;0;2513;361;0;1820;196;134;2150;163;5;21;189;52;17;M;37616
27875;0;24203;3672;0;2314;12;528;1924;144;40;2108;181;0;1;182;52;18;C;22978
16587;0;0;1533;0;1691;140;0;1254;773;63;2090;152;16;10;178;52;20;C;173816
22194;0;0;1640;0;1723;0;0;1422;0;27;1449;156;0;0;156;52;39;Q;143649
7542;0;0;2;0;2035;0;0;508;16;0;524;143;0;0;143;17;2;Q;56550
19941;0;0;2264;0;1414;0;409;1489;564;23;2076;116;52;0;168;52;15;C;14432
16492;0;0;992;0;1381;0;0;419;1520;59;1998;169;1;0;170;52;5;Q;172030
22965;0;0;3871;0;1580;0;16;1813;300;37;2150;165;0;37;202;52;32;H;9441
11322;0;0;123;0;1396;59;0;962;0;181;1143;141;0;5;146;52;0;G;155602
63142;0;0;6693;0;4043;0;0;1666;224;0;1890;158;0;0;158;52;21;K;5477
18739;0;325;3001;0;1276;0;0;1621;309;14;1944;144;13;0;157;52;20;E;76687
23291;0;0;2034;0;2554;0;0;1784;248;0;2032;168;0;0;168;4;31;C;132389
20450;0;0;2939;0;1704;0;507;1633;274;0;1907;146;10;0;156;52;29;C;38047
27819;0;0;5006;0;1682;0;0;1482;544;40;2066;119;49;0;168;52;25;C;135835
18478;0;0;1394;0;1516;123;0;1828;244;22;2094;168;0;12;180;52;18;C;52379
49606;0;0;31343;0;2504;0;0;1853;227;0;2080;160;0;0;160;52;27;K;95056
38867;0;0;3307;0;2907;0;0;615;1461;0;2076;90;83;0;173;52;21;C;44235
17236;0;0;1371;0;1371;0;0;1943;226;0;2169;152;0;0;152;52;27;B;153049
59580;0;0;4965;0;4965;0;0;1700;235;173;2108;157;0;0;157;52;28;C;135375
54000;0;0;7714;0;3857;0;0;1788;221;26;2035;117;52;0;169;52;9;C;121558
33456;0;0;1544;0;1907;0;0;1654;234;58;1946;147;0;0;147;52;33;Q;32118
26620;0;0;3760;0;1890;0;0;1914;345;4;2263;167;23;0;190;52;31;M;63667
32644;0;0;5561;0;2819;0;0;1813;32;0;1845;160;0;0;160;52;15;F;70520
28259;0;0;3637;0;1998;0;0;1720;299;0;2019;156;0;0;156;52;31;C;8041
30084;0;0;4364;0;1973;0;0;1790;242;0;2032;160;8;0;168;52;29;E;140483
39061;0;32439;6622;0;2660;0;0;1719;321;0;2040;167;1;0;168;52;26;C;10288
19684;0;0;3200;0;3328;0;0;2016;0;0;2016;152;16;0;168;52;32;G;7276
16789;0;0;1351;0;1649;0;0;1336;798;14;2148;161;77;0;238;39;6;Q;178171
17416;0;0;1721;0;1277;8;0;1643;361;100;2104;163;0;1;164;52;25;H;89880
22994;0;0;2355;0;2072;245;0;1675;235;212;2122;163;5;23;191;45;57;E;121302
77282;0;2500;10200;0;5350;0;0;1772;120;0;1892;168;0;0;168;52;10;C;182541
17032;0;0;2405;0;1440;0;0;1866;0;118;1984;158;0;0;158;52;20;H;116401
89425;0;68582;20843;0;5643;0;0;1639;336;0;1975;152;16;0;168;52;37;E;81101
19108;0;0;3644;0;1846;0;0;1027;1013;0;2040;126;42;0;168;52;35;C;162486
22442;0;0;2738;0;1400;0;0;1764;264;0;2028;113;43;0;156;52;26;H;11731
12474;0;0;1039;0;1039;0;0;1766;0;0;1766;168;0;0;168;52;20;Q;55019
32219;0;0;4820;0;2266;196;0;1625;317;171;2113;128;38;15;181;52;24;H;52133
30480;1121;0;6389;0;1832;0;0;1564;364;0;1928;128;33;0;161;52;30;J;108687
37250;0;0;2729;0;2729;0;0;1705;383;60;2148;158;10;0;168;52;39;J;35229
21784;0;0;1506;0;1623;120;0;1796;308;104;2208;179;0;11;190;52;23;C;87197
1527;0;0;1527;0;1880;263;0;1702;167;213;NA;172;0;21;193;4;20;B;133941
18692;0;0;1401;0;1396;56;0;1793;245;50;2088;148;24;5;177;52;28;C;173818
16265;0;177;1664;0;1435;0;0;1549;178;0;1727;132;40;0;172;42;19;C;142895
43987;0;0;10108;0;2929;0;0;1833;263;0;2096;176;0;0;176;52;22;E;121033
20615;0;0;3044;0;1363;0;0;1855;152;2;2009;164;0;0;164;52;15;N;184406
25937;0;0;3120;0;2068;732;0;2497;146;653;3296;235;2;67;304;52;15;N;124698
31680;0;462;2355;0;4010;0;0;1638;198;0;1836;115;37;0;152;52;26;Q;34700
23416;0;0;1;0;2119;0;0;1776;180;0;1956;168;0;0;168;52;22;F;162130
8702;0;0;1;0;1406;0;0;740;80;0;820;138;0;0;138;30;0;S;29472
27740;0;0;2343;0;2812;0;0;1555;180;0;1735;168;0;0;168;45;26;C;22541
24393;0;0;1;0;1598;0;0;1803;228;0;2031;173;0;0;173;52;28;J;105148
50982;0;0;3380;0;3317;0;0;1674;239;0;1913;131;26;0;157;52;23;K;33521
55507;0;0;6958;0;3710;0;0;1799;218;0;2017;168;0;0;168;52;26;G;172507
15364;0;0;2305;0;1102;0;0;1372;299;0;1671;124;13;0;137;52;22;N;17952
19278;0;0;2754;0;1377;0;0;0;2016;0;2016;0;168;0;168;52;10;G;26036
43811;0;0;3327;0;3331;0;0;1786;246;0;2032;167;1;0;168;52;31;C;167519
42875;0;3836;13;0;3197;0;423;1529;226;164;1919;154;1;20;175;52;24;C;144319
20682;14519;2500;3400;0;1955;201;0;1920;240;148;2308;167;13;19;199;52;30;H;159536
23648;823;0;1729;0;1734;0;5;1840;248;0;2088;163;5;0;168;52;21;J;156526
18659;0;2507;2498;0;1324;0;0;1675;409;0;2084;117;35;0;152;52;20;J;56756
35146;1496;1300;5913;0;2123;0;114;1641;231;0;1872;133;21;0;154;52;24;S;25346
20879;0;0;1593;0;1563;0;0;1639;401;0;2040;136;32;0;168;52;27;J;74179
25574;0;0;3685;0;1874;0;0;1686;21;18;1725;130;42;0;172;52;21;H;92056
56686;0;44389;12297;0;3829;0;0;921;279;0;1200;153;15;0;168;31;35;C;40000
20410;17424;0;2986;0;1478;12;37;1634;402;25;2061;106;69;1;176;52;20;G;170324
29679;0;25404;4275;0;2084;0;0;1718;358;0;2076;133;40;0;173;52;35;C;8004
31908;0;0;5236;0;2493;139;0;1695;447;77;2219;163;13;18;194;52;27;C;143375
31481;0;0;3193;0;2304;434;10;1676;304;370;2350;163;0;35;198;52;38;C;123316
16518;0;0;1331;0;1331;0;0;1390;609;16;2015;171;0;0;171;52;80;Q;176827
20556;0;0;4048;0;1546;0;0;1592;424;0;2016;156;12;0;168;52;40;C;182114
20316;0;0;1693;0;1693;0;0;1550;238;0;1788;137;14;0;151;52;30;Q;27367
17221;0;0;2630;0;1380;153;0;1339;682;40;2061;157;11;12;180;52;37;C;178889
25380;0;0;2916;0;2042;313;0;1744;294;130;2168;167;0;21;188;52;24;C;19745
38676;0;88;3402;0;2921;0;0;1430;552;13;1995;147;11;0;158;52;37;Q;172477
22032;0;0;2907;0;1836;0;0;1947;69;0;2016;168;0;0;168;52;6;H;125927
31408;0;0;2397;0;2397;0;0;1733;365;0;2098;161;14;0;175;52;31;C;3747
22628;0;0;1700;0;1700;0;0;918;361;0;1279;NA;NA;0;NA;39;25;Q;29782
20199;0;0;1468;0;1468;0;65;1660;140;0;1800;146;13;0;159;52;21;G;82377
24771;0;0;1878;0;1855;0;0;1587;700;0;2287;148;25;0;173;52;34;C;152424
41893;0;0;2149;0;3324;62;0;1729;347;65;2141;160;9;4;173;52;34;C;62868
11934;0;0;1381;0;1381;0;0;475;1557;0;2032;152;16;0;168;52;42;J;159623
44644;0;0;3384;0;NA;0;0;NA;NA;NA;NA;NA;NA;0;NA;0;0;K;123417
22307;0;0;1495;0;1685;10;0;1878;198;38;2114;168;5;1;174;52;14;C;80365
63566;59175;0;4391;0;5483;0;0;1631;158;0;1789;147;0;0;147;48;22;M;120656
22580;0;0;3246;0;1589;0;11;1722;220;10;1952;121;0;0;121;52;45;Q;56098
1986;0;0;13;0;1986;0;0;NA;NA;NA;NA;NA;NA;0;NA;4;15;C;82584
42795;0;0;10658;0;2709;377;0;1767;272;278;2317;128;40;21;189;52;34;C;164302
21250;0;0;3400;0;1551;0;0;1682;400;0;2082;162;6;0;168;52;39;C;115728
35585;0;658;4504;0;2719;0;1203;1695;389;2;2086;168;0;0;168;52;37;C;164640
36201;0;3958;3952;0;2516;0;347;1597;285;37;1919;131;29;0;160;52;25;C;31269
25500;0;0;3638;0;1819;0;0;1980;146;0;2126;165;7;0;172;52;18;G;33380
28000;0;0;4000;0;2000;0;0;1688;368;0;2056;160;0;0;160;48;32;F;18865
24826;0;0;3313;0;1987;319;0;1879;275;122;2276;193;1;26;220;52;23;G;103557
45100;391;25848;6025;0;3037;413;0;1606;376;278;2260;123;36;21;180;52;24;D;43033
21230;0;0;1452;0;1250;0;0;1984;0;231;2215;152;2;0;154;52;10;C;48914
20831;0;0;0;0;1866;0;0;1603;485;0;2088;154;14;0;168;52;17;F;2694
19742;0;0;1793;0;1817;393;37;1798;85;182;2065;168;0;32;200;49;1;C;58741
NA;0;0;5084;0;3616;847;0;1702;228;421;2351;159;0;42;201;52;24;D;97003
21156;0;0;3526;0;1763;0;0;2016;190;0;2206;168;0;0;168;52;190;G;116839
26885;0;23044;3841;0;1920;0;0;1939;251;0;2190;136;32;0;168;52;27;C;29493
18904;17403;0;1501;0;1482;128;25;1591;146;79;1816;152;13;14;179;52;22;Q;21472
23370;0;0;2854;0;1678;0;31;1608;422;20;2050;140;26;0;166;52;36;C;19733
28903;0;0;1000;0;2136;0;0;1650;0;0;1650;150;0;0;150;52;31;J;39911
26137;0;21811;4325;0;2029;0;0;1549;280;0;1829;136;22;0;158;52;17;Q;85317
30947;0;27233;3714;0;2418;0;0;1343;486;6;1835;146;6;0;152;52;28;Q;138213
7084;0;0;1260;0;NA;0;0;493;1598;6;2097;0;168;0;168;24;0;C;137568
18227;33;0;2889;0;1490;0;34;1754;262;22;2038;161;7;13;181;52;30;G;174945
22681;0;0;1342;0;2184;0;161;1665;0;12;1677;155;0;0;155;52;46;J;151436
22472;0;0;3082;0;1604;53;0;1644;283;87;2014;155;2;5;162;52;29;M;106254
28248;0;0;2084;0;2045;0;0;1673;361;3;2037;156;11;0;167;52;30;C;96609
23748;0;0;3381;0;1661;0;0;1096;992;64;2152;166;2;0;168;52;41;C;89949
46313;0;0;12637;0;2774;175;0;1583;177;194;1954;147;8;16;171;52;19;B;108297
30904;0;0;5146;0;2242;13;0;1682;344;75;2101;164;4;8;176;52;25;C;126323
26314;0;0;4605;0;2137;0;132;1256;0;64;1320;144;0;0;144;52;26;H;86299
30746;0;5;3404;0;2628;0;742;1564;296;0;1860;156;0;0;156;52;24;C;176920
63624;0;11480;14667;0;4780;0;0;1367;680;54;2101;151;15;0;166;52;20;M;5341
39555;0;0;3372;0;2996;460;105;2308;184;484;2976;196;30;6;232;52;23;H;6537
34792;0;212;4802;0;2672;121;503;1588;222;36;1846;150;6;9;165;52;35;E;44451
25052;0;0;4228;0;2114;0;0;1436;81;0;1517;168;0;0;168;52;22;F;104691
30545;0;0;1424;0;2419;204;361;1816;160;299;2275;160;8;20;188;52;20;F;21178
14993;0;0;2341;0;1086;99;0;1595;320;49;1964;123;13;10;146;52;23;R;46899
29843;0;0;3924;0;2322;0;0;1125;258;7;1390;130;0;10;140;52;27;Q;24587
59896;0;0;7132;0;3978;0;0;1588;285;213;2086;150;7;0;157;52;26;K;36225
42782;0;0;5869;0;3175;0;0;665;227;0;892;140;10;0;150;51;27;K;51873
25859;0;0;3148;0;1918;0;0;1728;288;150;2166;136;32;0;168;52;19;R;145426
20952;0;0;1;0;1746;65;0;1805;0;63;1868;168;0;20;188;48;15;F;88154
31449;0;0;2180;0;2242;0;0;1643;283;0;1926;116;52;0;168;52;17;C;85789
32141;0;0;3472;0;2404;0;0;1613;485;1;2099;168;0;0;168;52;33;C;12562
28006;0;1396;2300;0;2211;0;53;NA;NA;NA;NA;NA;NA;0;NA;52;30;Q;182875
41757;0;0;2290;0;1966;39;0;1588;428;135;2151;163;5;2;170;52;32;C;5409
24451;0;0;3048;0;1748;0;0;1773;347;0;2120;168;0;0;168;52;32;C;107023
26371;0;22287;4084;0;1978;0;0;1292;344;18;1654;132;22;2;156;52;34;Q;103123
23519;0;0;1692;0;1747;183;107;1701;396;200;2297;149;27;16;192;52;22;J;138721
22568;0;0;2771;0;1102;0;28;1594;495;0;2089;104;64;0;168;52;30;C;37305
21524;90;16673;1673;0;1178;0;0;1736;113;66;1915;152;0;0;152;52;10;G;71894
NA;0;0;0;0;NA;0;0;1654;434;0;2088;164;4;0;168;0;35;C;63855
28994;0;0;4142;0;2071;0;0;2081;57;0;2138;168;0;0;168;52;8;M;85583
26559;0;0;1817;0;1993;227;0;1928;200;190;2318;168;0;18;186;52;12;C;38453
8185;0;0;797;0;1595;0;0;853;114;0;967;140;28;0;168;24;13;G;140122
19051;0;0;3236;0;1623;0;0;1840;192;0;2032;168;0;0;168;52;24;H;173544
42144;0;5112;13;0;3343;454;0;1689;343;142;2174;164;4;21;189;52;34;C;144354
25509;0;0;3957;0;1736;0;0;1835;144;0;1979;160;0;0;160;52;18;N;184438
25991;0;0;3474;0;1850;102;0;1795;293;89;2177;164;4;9;177;52;31;N;142035
28461;0;0;3842;0;2222;0;0;1550;366;44;1960;101;60;0;161;52;54;Q;32384
19037;0;0;122;0;1320;0;0;1563;363;11;1937;106;50;0;156;52;32;Q;153339
64498;0;0;12756;0;4574;0;0;1630;308;0;1938;152;8;0;160;52;33;H;168102
62231;1035;43978;17218;0;3738;45;0;1383;347;99;1829;124;29;1;154;52;24;K;185148
29877;0;0;1;0;1918;0;0;1845;0;157;2002;154;0;14;168;52;20;C;58802
29319;0;0;5952;0;2329;0;0;1495;306;0;1801;125;30;0;155;52;38;S;68773
37401;0;1945;1916;0;3073;73;0;1712;224;60;1996;158;0;5;163;52;22;H;124327
25529;0;0;3212;0;1849;0;0;1736;304;12;2052;168;0;0;168;52;28;C;72425
27773;0;0;2925;0;2338;186;0;1701;228;189;2118;114;46;16;176;48;23;E;43521
25508;0;0;1535;0;1888;25;0;1318;496;313;2127;119;28;21;168;52;28;Q;171657
30027;0;0;2957;0;2179;26;377;1853;200;54;2107;168;0;2;170;52;20;C;104947
27975;0;0;4852;0;2100;14;0;1690;255;10;1955;156;0;1;157;52;26;E;68396
48260;0;0;6937;0;3304;25;0;1754;351;232;2337;173;4;24;201;52;38;N;15885
30947;0;28962;1985;0;2488;0;167;1647;225;0;1872;136;14;0;150;52;28;Q;111643
32256;175;25290;6011;0;2128;7;25;1625;200;15;1840;155;1;1;157;52;31;E;7383
28240;0;0;2809;0;2161;127;0;1802;290;44;2136;152;16;9;177;52;26;C;46112
48684;0;1500;6662;0;3540;0;0;1720;158;0;1878;157;0;0;157;52;18;K;53603
25710;0;1588;555;0;2200;224;2;1727;313;160;2200;167;0;17;184;52;14;C;165476
37918;0;0;2005;0;3140;0;0;1500;264;0;1764;106;36;0;142;52;43;Q;147166
33275;0;775;4526;0;2762;0;0;1439;561;0;2000;173;3;0;176;52;37;C;172727
23747;0;0;2037;0;1840;0;0;1544;544;14;2102;148;20;0;168;52;31;F;163257
28393;0;0;4813;0;2045;79;0;1811;221;29;2061;167;1;6;174;52;28;C;132819
49561;0;4995;5502;0;4130;521;0;1382;486;209;2077;106;54;24;184;52;45;J;118299
59709;0;0;2044;0;13883;0;0;944;0;0;944;240;0;0;240;17;12;H;67308
55770;0;0;1539;0;4900;0;0;1437;116;165;1718;156;0;20;176;52;28;Q;83148
34024;0;0;7296;0;2666;280;300;1479;299;107;1885;137;31;16;184;52;27;C;57408
23671;0;21998;1673;0;1801;0;0;1252;576;70;1898;138;12;6;156;52;31;Q;174858
15555;0;0;1331;0;1376;110;0;1748;164;42;1954;159;0;12;171;52;22;Q;17615
4148;0;0;360;0;1026;0;0;40;598;0;638;0;176;0;176;16;0;S;82157
23244;0;0;2373;0;1788;0;0;1600;272;0;1872;156;0;0;156;52;34;Q;168427
16725;0;0;1285;0;1214;0;0;1856;280;0;2136;168;0;0;168;52;23;C;1328
55253;0;0;4933;0;4164;0;0;1294;302;0;1596;103;37;0;140;52;35;K;19889
28159;0;112;1952;0;2198;0;103;1019;720;40;1779;149;0;5;154;52;35;Q;168834
65728;0;1092;8536;0;3925;0;0;2040;384;0;2424;168;0;0;168;52;39;C;126496
32302;0;535;4718;0;2533;0;223;1787;303;59;2149;150;18;0;168;52;35;C;28745
23773;0;0;2490;0;1933;231;200;2158;182;364;2704;243;0;45;288;52;24;G;165412
16321;0;0;1759;0;1351;0;0;1820;256;75;2151;100;67;0;167;52;23;C;58693
38084;0;0;3939;0;2868;0;0;1558;482;163;2203;160;8;0;168;52;13;C;152741
53214;0;0;11978;0;3353;0;0;1605;261;8;1874;154;2;0;156;52;29;G;104120
28479;0;0;7315;0;2239;0;0;1589;624;2;2215;168;21;0;189;52;40;B;13170
21795;0;0;1;0;1497;0;0;1776;230;0;2006;128;40;0;168;4;9;F;79671
49711;0;0;5114;0;3699;0;0;1776;311;0;2087;176;0;0;176;52;27;C;156574
97234;0;0;4532;0;4500;0;0;1613;248;0;1861;117;36;0;153;51;32;K;113697
18562;0;0;2;0;1388;0;70;1915;0;69;1984;179;0;0;179;52;16;G;37041
23703;0;0;3777;0;1701;0;0;1653;171;1;1825;156;0;0;156;52;24;E;89287
23000;0;0;2180;0;2180;94;0;2016;8;16;2040;174;0;6;180;52;1;C;64543
57240;0;0;9026;0;2638;113;0;1690;342;451;2483;160;8;5;173;52;20;F;182939
36369;0;0;2211;0;2635;0;0;1588;320;37;1945;135;23;0;158;52;29;K;119301
39620;0;0;2873;0;2971;0;0;1980;0;0;1980;157;0;0;157;52;30;K;100971
44582;0;38579;6003;0;2984;147;0;1595;313;59;1967;148;10;12;170;52;20;K;134110
24039;0;0;0;0;1788;0;0;1487;430;0;1917;122;46;0;168;52;38;C;161079
26968;0;0;5175;0;1819;0;0;1596;213;27;1836;142;7;4;153;44;27;R;25404
27805;0;0;3949;0;1988;0;0;1574;0;20;1594;145;0;0;145;52;24;M;155662
44602;0;0;12846;0;2297;315;0;1695;311;327;2333;171;8;23;202;52;28;G;65569
102074;0;0;23441;0;6850;0;0;1792;232;0;2024;168;0;0;168;52;29;G;124739
24196;0;0;1633;0;1679;0;0;1650;66;78;1794;140;0;0;140;52;17;R;25333
23000;0;0;5000;0;1500;20;0;1680;190;10;1880;140;10;1;151;52;26;G;154977
21131;0;4773;1753;0;1765;0;0;1609;263;0;1872;123;21;0;144;52;27;N;323
19047;0;0;1434;0;1546;45;0;1522;566;24;2112;160;8;4;172;52;39;C;146306
56818;0;0;8179;0;3353;0;0;1274;226;240;1740;153;0;0;153;52;33;D;79815
32155;0;0;4076;0;2038;187;0;1566;301;184;2051;133;19;10;162;52;24;K;89420
16936;0;0;1271;0;1325;0;0;1782;267;0;2049;163;4;0;167;52;19;C;103051
16655;0;0;1;0;2043;0;0;1256;6;0;1262;155;0;0;155;40;0;M;113545
23941;0;0;3990;0;1995;0;0;1958;58;25;2041;160;8;9;177;52;15;H;125964
28806;0;0;3655;0;2206;0;0;1738;278;211;2227;161;7;30;198;52;43;G;120801
35496;0;0;4668;0;2571;0;0;1825;191;0;2016;162;6;0;168;52;22;H;114809
38392;0;1423;5958;0;2573;221;0;1252;728;15;1995;154;7;3;164;52;28;C;120077
NA;0;0;0;0;1281;0;0;1853;120;0;1973;168;0;0;168;52;15;C;60251
22623;0;0;2650;0;1580;288;0;1717;418;287;2422;156;7;26;189;52;25;H;100012
20231;0;0;1460;0;1444;0;0;2007;30;0;2037;168;0;0;168;52;4;C;1557
24765;0;0;4686;0;1895;0;0;1731;302;0;2033;160;8;0;168;52;33;E;25250
68491;0;0;16769;0;4018;0;0;NA;NA;NA;NA;0;104;0;104;48;74;R;126723
30191;0;0;3575;0;2218;0;0;1772;301;0;2073;164;4;0;168;52;30;C;24214
56313;0;0;8049;0;3887;0;0;1558;347;0;1905;152;4;0;156;52;36;K;103307
NA;0;0;0;0;NA;0;0;1718;0;0;1718;158;0;0;158;0;26;H;33319
31671;0;0;2731;0;2961;731;0;1426;1073;144;2643;121;79;47;247;52;38;N;145919
35628;0;0;8024;0;1962;0;0;1322;699;0;2021;117;51;0;168;52;20;C;108573
22015;0;0;2968;0;1644;139;0;1705;135;65;1905;144;4;8;156;52;10;E;25961
59647;0;0;4063;0;4063;0;0;1795;191;0;1986;160;8;0;168;52;24;J;30773
28507;0;0;3117;0;2143;340;53;1619;224;159;2002;159;9;26;194;52;28;C;12700
21800;0;0;4100;0;1952;0;0;1252;402;4;1658;148;8;0;156;52;38;E;26806
30544;0;0;4218;0;2160;22;0;1656;303;51;2010;135;24;10;169;52;22;I;123273
74847;1849;0;6325;0;4803;0;0;1781;252;8;2041;160;8;0;168;52;30;J;50912
44401;0;0;7734;0;4011;0;0;1811;277;0;2088;166;2;0;168;52;27;C;129472
19490;0;0;1411;0;1533;121;0;1864;225;68;2157;168;0;11;179;52;21;C;125284
15433;0;0;858;0;4644;1056;0;792;0;330;1122;240;0;100;340;14;9;H;67304
19743;0;0;1518;0;1497;0;0;1600;0;0;1600;168;0;0;168;52;30;C;137383
83382;0;0;9414;0;6859;0;0;1865;260;231;2356;169;13;17;199;52;30;Q;181943
19631;0;0;2482;0;1554;310;50;1682;303;626;2611;145;51;52;248;52;41;N;74404
36215;0;0;5140;0;2687;0;0;1680;321;0;2001;152;14;0;166;52;16;G;47607
20529;0;20528;1;0;1772;0;0;1872;0;0;1872;168;0;0;168;49;0;R;101276
49451;0;0;6390;0;2918;0;0;1760;328;166;2254;168;0;0;168;52;15;J;120054
28342;0;0;3589;0;1951;134;0;1665;238;239;2142;128;40;11;179;52;27;G;139009
16395;14268;0;2127;0;1984;0;0;1087;0;0;1087;128;6;0;134;52;30;Q;21473
16021;0;0;672;0;1534;68;326;1696;144;51;1891;155;0;7;162;46;15;H;130196
22048;0;0;1696;0;2585;0;0;1696;280;0;1976;149;19;0;168;52;20;C;47757
25473;0;0;2269;0;2018;55;0;1782;249;57;2088;167;0;3;170;52;31;J;31408
20348;0;0;2900;0;1450;0;0;1690;260;26;1976;110;46;0;156;52;323;M;113477
25512;0;2579;2115;0;2045;0;0;1391;564;15;1970;150;18;0;168;52;37;C;20422
47460;0;0;4755;0;3955;0;0;1700;294;0;1994;163;5;0;168;52;21;C;99316
24894;0;0;1809;0;1916;83;0;1728;386;26;NA;165;3;7;175;52;25;C;116291
19032;0;0;0;0;2310;0;0;1834;190;0;2024;160;8;0;168;52;24;C;11372
25294;0;0;2390;0;1906;106;35;NA;NA;NA;NA;NA;NA;NA;NA;0;0;Q;185888
17593;0;0;1473;0;1473;0;0;1696;284;0;1980;157;8;0;165;0;0;Q;4600
16546;0;0;1957;0;1391;0;0;1844;0;0;1844;168;0;0;168;50;20;M;74221
37646;0;0;5378;0;2689;0;0;1656;209;0;1865;151;0;0;151;52;29;N;159011
26145;0;0;3883;0;1677;0;0;1765;285;35;2085;162;6;0;168;52;21;C;81403
31990;0;0;4570;0;2285;0;0;1772;316;0;2088;160;8;0;168;52;22;J;181453
60992;0;0;4550;0;3835;624;0;1782;246;285;2313;169;0;37;206;52;41;E;161839
22636;0;0;3234;0;1617;0;0;1372;668;24;2064;133;35;0;168;52;35;C;87087
44245;0;0;3563;0;3209;0;0;1583;432;0;2015;164;0;0;164;52;46;C;61884
23946;0;0;3383;0;1692;0;0;1840;248;0;2088;152;15;0;167;52;21;D;37258
21808;0;0;1522;0;1562;40;0;1585;0;73;1658;120;48;3;171;52;180;C;10130
36632;0;0;2660;0;2660;0;0;1982;301;0;2283;172;0;0;172;52;19;M;128392
20971;0;0;1711;0;1711;0;0;1711;409;40;2160;168;0;0;168;52;29;C;128413
22979;1200;0;2722;0;1721;140;140;1777;251;187;2215;172;8;16;196;52;27;N;102228
42670;0;0;4092;0;3281;88;0;1791;232;121;2144;169;0;14;183;52;18;J;70152
40832;0;0;4064;0;3064;0;0;1747;0;0;1747;168;0;0;168;52;21;C;142564
43142;0;23904;2530;0;3106;125;310;1595;154;79;1828;154;2;7;163;52;24;Q;654
17618;0;1320;0;0;1282;0;0;1843;300;3;2146;160;8;0;168;52;18;C;139610
33758;0;0;0;0;2753;0;0;1579;464;143;2186;142;26;19;187;52;34;C;35900
28869;0;954;4575;0;2407;0;0;1454;331;40;1825;155;4;3;162;52;35;N;167021
20332;0;0;2062;0;1478;60;0;1478;450;20;1948;151;7;7;165;52;36;C;175421
40192;0;0;6462;0;2693;200;263;1842;234;185;2261;184;0;14;198;52;31;N;97535
49447;0;0;8792;0;3343;0;0;1595;388;0;1983;152;7;0;159;52;25;D;42883
51227;0;864;3860;0;3205;318;210;1634;302;322;2258;166;7;22;195;52;35;H;143210
27578;0;0;1966;0;2138;0;0;1879;160;8;2047;168;0;0;168;52;20;C;128199
34300;0;0;2;0;2450;0;0;2112;0;0;2112;176;0;0;176;4;21;M;170040
29971;0;0;2832;0;2093;16;0;1302;753;177;2232;156;1;1;158;4;31;E;48284
23160;0;0;4231;0;1860;115;0;1730;286;53;2069;164;0;10;174;52;20;C;46927
87031;1150;0;17019;0;5763;0;0;1880;145;5;2030;164;0;0;164;52;15;K;26252
29528;0;0;2271;0;2271;837;0;1690;326;294;2310;167;1;31;199;52;24;J;116337
28901;0;0;1000;0;2194;146;0;1650;0;25;1675;150;0;10;160;52;31;J;39910
13868;0;0;0;0;1166;0;0;2024;40;0;2064;176;0;0;176;43;5;S;27431
21222;0;0;1777;0;1581;26;0;1599;456;53;2108;122;25;2;149;52;20;M;16637
15067;0;0;1167;0;1264;0;0;0;2088;0;2088;0;168;0;168;52;0;C;125372
18991;0;0;13;0;1673;0;0;1415;609;26;2050;140;28;0;168;52;19;C;88416
23113;0;0;1454;0;1757;303;0;1986;81;244;2311;160;8;30;198;52;5;C;62116
48012;0;0;15;0;4001;0;0;2076;0;0;2076;173;0;0;173;52;13;S;53326
92488;735;11733;10253;0;6485;219;1943;1327;541;47;1915;145;0;5;150;52;40;J;103338
36405;0;0;5389;0;2587;0;0;1607;384;19;2010;163;0;0;163;52;20;C;172375
22613;0;1619;1578;0;1743;0;0;1598;230;0;1828;129;21;0;150;52;29;Q;85086
7976;0;7358;618;0;1855;0;0;549;79;0;628;144;7;0;151;16;10;Q;24395
34490;0;24530;4088;0;2789;38;0;1580;20;40;1640;143;0;20;163;52;13;H;86946
21092;0;0;4593;0;1374;48;0;1758;313;25;2096;168;0;5;173;52;19;H;57942
26950;0;0;3850;0;2168;0;0;1784;294;0;2078;172;0;16;188;52;36;N;9552
23268;0;0;3423;0;1646;0;0;1752;281;0;2033;152;17;0;169;52;35;N;9837
18779;0;0;2495;0;1950;0;0;1758;21;22;1801;112;56;0;168;52;16;H;173533
24588;0;0;2046;0;2264;521;37;1658;273;404;2335;165;0;50;215;52;37;Q;94620
23739;0;0;3742;0;1793;0;0;1720;0;0;1720;157;0;0;157;52;26;C;134749
29772;0;0;2580;0;2284;0;0;1388;461;3;1852;151;0;0;151;52;41;Q;114349
25352;1142;17300;4417;0;1700;136;0;1658;264;123;2045;167;0;13;180;52;27;D;54631
31142;0;0;4932;0;2293;0;0;1569;272;8;1849;148;5;0;153;52;28;C;136034
21038;0;0;2544;0;1272;0;48;1814;223;132;2169;173;0;0;173;52;21;E;27731
18812;0;0;2700;0;1476;0;0;1931;0;0;1931;168;0;0;168;52;16;R;50451
30895;0;0;2503;0;2224;0;67;1694;338;29;2061;113;55;0;168;52;40;C;28567
23133;0;0;1680;0;1732;0;0;1433;607;35;2075;141;27;0;168;52;21;S;164656
39539;19;2576;5529;0;3293;0;0;1800;180;12;1992;163;0;0;163;52;27;J;21921
36965;0;4526;3447;0;2300;0;0;1715;321;0;2036;126;42;0;168;52;36;C;135172
46429;0;0;5710;0;3434;0;261;1911;180;97;2188;176;0;12;188;52;15;G;135692
68723;0;0;6042;0;3941;0;0;1673;218;0;1891;155;2;0;157;52;22;K;5502
21840;0;0;2794;0;1418;0;0;1572;300;0;1872;126;82;0;208;52;29;G;110111
22283;0;0;2978;0;1880;0;0;1316;308;0;1624;151;0;0;151;51;22;N;37553
49770;0;0;5121;0;3799;296;0;1706;144;23;1873;148;16;12;176;52;14;D;59021
30374;0;1200;3038;0;2046;274;67;1695;348;274;2317;120;48;22;190;52;22;H;50698
38460;0;0;2911;0;3241;10;0;1745;71;20;1836;167;1;7;175;52;21;C;89014
24286;0;2112;3960;0;1962;0;0;1595;277;0;1872;150;6;0;156;52;28;Q;99995
20678;0;0;4468;0;1792;87;0;1766;264;89;2119;165;3;7;175;52;29;C;142531
58413;2034;0;11781;0;4188;0;0;1729;343;0;2072;162;8;0;170;52;33;C;77490
46348;0;1000;2109;0;3775;864;0;1603;473;478;2554;170;3;50;223;52;28;C;123875
31253;0;0;393;0;1965;483;0;1675;277;263;2215;160;8;34;202;52;24;E;112344
30481;0;0;6086;0;2172;0;437;1450;700;9;2159;165;8;0;173;52;29;C;180398
30371;0;0;3290;0;2255;0;0;1645;443;0;2088;154;14;0;168;52;36;C;172424
13757;0;0;1523;0;1321;0;0;1554;68;78;1700;167;0;0;167;45;51;H;52079
16608;0;0;2768;0;1384;0;0;1738;278;0;2016;168;0;0;168;52;52;G;121983
36449;0;0;3177;0;1580;477;0;1745;309;192;2246;152;16;40;208;52;38;I;28259
31538;0;0;2628;0;2523;134;0;1524;537;19;2080;168;0;10;178;52;20;F;126094
47335;0;0;6537;0;3006;30;564;1653;443;118;2214;150;18;2;170;52;41;D;38260
35981;0;0;6345;0;2625;0;498;1642;541;0;2183;152;40;0;192;52;64;C;7658
21543;0;0;1704;0;1707;122;0;1589;266;21;1876;136;14;0;150;52;26;Q;114367
16913;0;0;1294;0;2079;9;72;1002;771;5;1778;127;38;1;166;52;23;Q;122210
29662;0;0;8406;0;1776;0;0;1632;770;0;2402;124;78;0;202;52;31;H;55146
30200;0;0;6411;0;2217;127;0;1214;877;77;2168;130;43;0;173;52;36;C;97593
20462;0;0;1339;0;1514;0;315;1709;0;360;2069;153;0;29;182;52;30;Q;179668
36727;0;0;2709;0;2783;0;0;1900;317;18;2235;160;8;0;168;52;14;J;67273
83131;0;0;8788;0;7106;0;0;1984;0;0;1984;240;0;0;240;52;24;H;138757
26674;0;0;2944;0;2175;152;0;1711;217;240;2168;152;8;13;173;48;22;E;43554
21005;0;0;3048;0;2321;186;206;1541;0;49;1590;206;0;22;228;37;0;H;40948
24439;0;0;3148;0;2096;72;0;1444;325;199;1968;132;40;6;178;52;41;I;167440
15776;0;0;2057;0;1891;0;0;920;122;106;1148;108;14;10;132;32;17;Q;33075
4627;0;0;445;0;1329;0;0;484;20;0;504;152;8;0;160;14;3;N;9832
55625;2232;0;12825;0;3424;0;0;1572;492;0;2064;152;16;0;168;52;27;C;118031
30723;0;0;1;0;3333;301;0;1463;626;192;2281;168;0;21;189;52;15;F;39903
28297;0;0;2138;0;2138;0;0;1880;156;0;2036;168;0;0;168;52;19;C;173422
32128;0;2040;4679;0;2283;13;0;1539;333;56;1928;148;4;4;156;52;33;R;171358
23098;0;2400;3650;0;1000;0;0;1206;541;0;1747;79;14;0;93;52;26;C;4584
27224;0;0;2641;0;2300;0;54;1309;258;123;1690;138;42;0;180;52;39;Q;151966
27159;0;0;2167;0;1703;14;0;1666;410;22;2098;136;32;1;169;52;13;C;9413
19180;0;0;1387;0;1402;0;0;1728;295;30;2053;160;8;0;168;52;36;C;78132
40641;46;369;8410;0;4486;199;0;1587;501;148;2236;150;18;11;179;52;20;J;85763
25557;0;0;3474;0;1770;33;0;1697;271;0;1968;159;9;3;171;52;21;C;91146
21488;0;0;3664;0;1498;114;0;1744;352;93;2189;167;1;11;179;52;16;E;72530
26556;0;0;3878;0;1874;82;218;1782;250;30;2062;148;20;6;174;52;30;C;135427
23508;0;0;3208;0;1617;0;0;1629;323;42;1994;126;40;0;166;52;42;G;179195
40580;0;0;2;0;2813;0;0;1752;131;0;1883;167;0;0;167;52;15;D;96959
38789;0;433;2171;0;2456;0;0;1713;227;86;2026;162;0;0;162;52;32;Q;125593
21878;0;17858;3539;0;1484;0;0;1766;217;21;2004;121;38;0;159;52;20;D;39686
5797;0;0;357;0;1426;0;195;539;57;0;596;179;0;0;179;13;4;Q;52710
99868;0;2870;18692;0;6535;0;0;1916;224;0;2140;192;0;0;192;52;23;I;69209
28542;0;0;2112;0;2193;0;0;1737;284;65;2086;163;5;0;168;52;27;E;6139
25569;0;0;1041;0;1975;197;0;1744;349;115;2208;152;7;16;175;52;25;C;3980
38780;258;0;10353;0;2723;0;0;1573;369;16;1958;149;11;0;160;52;32;H;140546
33998;0;0;4091;0;2169;72;137;1650;427;121;2198;156;9;6;171;52;20;C;8324
147805;0;18000;16239;0;11918;0;0;1716;204;0;1920;160;0;0;160;52;26;K;119081
42426;0;0;3015;0;4687;0;0;1720;200;0;1920;152;8;0;160;52;25;K;149784
25583;0;17479;3421;0;1902;11;10;1432;430;15;1877;157;11;1;169;50;34;C;134428
38046;18;19;4015;0;2808;199;47;1840;347;187;2374;153;73;13;239;52;28;J;105618
22968;174;0;2844;0;1770;108;0;1995;175;90;2260;172;0;10;182;52;13;I;65992
22996;0;0;3272;0;1636;0;0;1843;182;0;2025;168;0;0;168;52;23;R;173197
26318;0;20942;1735;0;2077;0;177;1583;234;9;1826;143;12;1;156;52;31;Q;139481
32347;27954;620;3773;0;2523;189;0;1667;421;83;2171;147;21;10;178;52;32;C;33271
30881;0;0;2067;0;2261;0;0;1403;551;7;1961;144;21;0;165;52;28;Q;105
32144;0;0;1922;0;2337;0;287;1574;298;187;2059;128;23;0;151;52;45;Q;154371
118230;0;0;23063;0;7858;0;0;1648;237;0;1885;113;45;0;158;52;27;K;5462
49507;0;0;5301;0;3648;0;0;1304;321;188;1813;134;2;18;154;52;47;M;57470
17436;0;0;2906;0;1453;0;0;2016;190;24;2230;168;38;2;208;52;190;G;116831
24861;0;0;1972;0;1935;0;65;1372;706;16;2094;127;41;0;168;52;30;C;109065
46112;0;0;6847;0;4386;0;0;1703;385;0;2088;168;0;0;168;52;36;M;14602
25066;0;0;4558;0;1703;34;0;1447;462;52;1961;153;4;3;160;52;22;G;156321
34436;0;0;2648;0;2649;0;0;1620;456;0;2076;153;20;0;173;52;20;C;134407
16502;1827;4726;3996;0;2866;0;0;1759;273;0;2032;158;10;0;168;52;21;C;10051
20076;0;0;1175;0;1673;0;0;1848;259;0;2107;156;12;0;168;52;19;G;101796
18730;0;0;1426;0;1426;0;0;1821;283;0;2104;168;5;0;173;52;26;C;12286
11021;0;0;1492;0;1662;0;0;1071;81;0;1152;157;10;0;167;29;7;C;76715
16488;0;0;250;0;1374;0;0;1980;0;0;1980;180;0;0;180;50;10;H;46189
36484;0;0;4361;0;3128;240;116;1658;362;35;2055;158;11;0;169;52;29;C;91637
26993;0;0;3331;0;1666;0;0;1884;147;8;2039;158;10;0;168;52;19;G;123294
9313;0;0;705;0;1676;42;72;977;142;25;1144;149;18;11;178;28;16;C;113656
24268;0;0;4186;0;2026;0;0;1888;223;0;2111;168;0;0;168;52;17;C;94659
25506;0;0;4066;0;2008;181;0;1585;520;18;2123;140;28;12;180;52;21;C;36882
34700;0;0;20346;0;2147;0;0;1952;128;0;2080;160;0;0;160;52;16;K;95075
23589;0;0;3662;0;1700;0;0;1329;233;380;1942;149;8;0;157;52;23;G;150828
30759;0;0;5369;0;2852;0;0;1578;292;0;1870;156;3;0;159;52;25;E;173706
14942;0;0;1000;0;1324;0;0;2015;0;0;2015;167;0;0;167;52;0;M;90785
16178;0;0;2170;0;1139;0;0;1690;350;0;2040;166;2;0;168;52;25;H;45012
43400;38726;620;4054;0;3334;764;0;1772;316;449;2537;168;0;78;246;52;33;C;33286
14979;0;0;1431;0;1113;43;0;1039;539;18;1596;119;7;3;129;52;14;J;182081
1987;0;0;1987;0;1987;0;0;NA;NA;NA;NA;NA;NA;0;NA;4;20;J;177342
20018;0;0;2033;0;1435;0;0;1980;329;32;2341;134;0;0;134;51;23;H;87890
44475;0;3597;1597;0;1903;123;0;1758;318;129;2205;165;8;11;184;52;18;C;166157
12065;0;0;2538;0;1872;0;0;280;1232;13;1525;0;126;0;126;52;0;K;44523
27494;0;712;1645;0;2366;0;121;1523;348;0;1871;122;30;0;152;52;31;Q;102617
22183;0;0;10701;1533;NA;0;0;1204;53;0;1257;140;0;0;140;31;0;I;32750
18727;0;0;1219;0;1284;0;0;1866;166;92;2124;168;0;0;168;52;21;N;155413
23259;0;0;1789;0;1789;0;0;1804;272;0;2076;160;0;0;160;52;16;J;82306
18992;0;0;2654;0;1615;0;0;1805;227;38;2070;150;18;0;168;52;17;C;146179
21923;0;0;3102;0;1551;0;0;1542;0;0;1542;163;18;0;181;52;53;C;108994
19559;355;16930;1479;0;1490;0;0;1563;249;0;1812;114;36;0;150;52;28;M;18970
18255;0;0;1360;0;1502;62;0;1789;187;68;2044;157;0;7;164;48;22;C;56586
26472;0;2451;2196;0;1809;0;127;1814;210;0;2024;160;8;0;168;52;26;C;121115
60275;0;0;8678;0;4007;0;0;1876;305;4;2185;166;12;0;178;52;31;C;181551
23322;0;0;3139;0;1408;238;0;1614;311;268;2193;161;2;20;183;46;18;N;143906
26089;0;23879;1979;0;1998;0;0;1608;216;0;1824;153;0;0;153;52;32;Q;54402
20101;0;0;1356;0;1606;53;0;1846;386;54;2286;171;1;4;176;52;19;C;109780
18597;0;0;1501;0;1410;0;0;1477;155;0;1632;144;24;0;168;52;19;C;55682
22347;0;0;2437;0;1790;136;0;1640;448;90;2178;165;3;10;178;52;20;C;172174
29778;0;0;3959;0;2449;0;0;1614;0;0;1614;168;0;0;168;52;33;C;68720
47028;0;0;6102;0;3277;173;0;1728;421;133;2282;120;64;8;192;52;42;C;125484
26418;0;0;5150;0;1755;67;129;1280;748;34;2062;143;25;5;173;52;33;C;91267
24219;0;0;3563;0;NA;0;0;2016;0;0;2016;168;0;0;168;52;26;M;139443
32885;0;3732;2263;0;2327;0;0;1540;273;41;1854;148;0;0;148;52;34;S;113826
25569;0;0;4503;0;2130;0;0;1650;438;0;2088;123;45;0;168;52;35;C;5173
59792;0;1089;5480;0;3627;0;0;1591;216;18;1825;158;0;0;158;52;26;H;143045
26863;0;0;3871;0;2757;0;147;NA;NA;NA;NA;NA;NA;0;NA;52;0;Q;93192
28653;0;623;4744;0;1969;30;0;1542;259;38;1839;151;0;4;155;52;28;R;475
31817;0;0;4492;0;2248;0;0;1785;263;0;2048;160;8;0;168;52;19;M;179234
109857;0;97041;12816;0;7000;0;0;1860;220;0;2080;168;0;0;168;52;21;C;3379
30255;0;110;1913;0;2479;0;0;1473;210;48;1731;149;0;7;156;52;35;Q;168830
24422;0;0;4404;0;2056;0;119;1606;162;49;1817;141;14;7;162;52;21;Q;51733
21125;0;0;1625;0;1625;0;0;1816;0;0;1816;180;3;0;183;52;120;M;6283
44126;0;2633;2231;0;3057;731;0;1605;350;561;2516;101;62;31;194;35;26;M;103815
13542;0;0;866;0;1059;7;10;1786;550;7;2343;211;0;1;212;52;29;N;91305
9705;0;0;0;0;NA;0;0;891;0;0;891;NA;NA;0;NA;26;0;I;126790
46156;0;0;4189;0;3073;300;0;1790;436;117;2343;168;55;24;247;52;30;J;16556
38173;0;0;7152;0;2930;0;229;1591;245;211;2047;130;22;25;177;52;33;Q;85011
44000;0;40517;2232;0;3470;0;136;1421;403;71;1895;118;33;0;151;52;28;Q;169500
36755;0;0;4232;0;2007;0;0;1632;0;208;1840;150;0;0;150;4;18;M;92474
4344;0;0;339;0;1357;0;0;0;492;6;498;168;0;0;168;12;0;G;26042
24265;0;0;1714;0;1714;0;0;1886;155;4;2045;148;20;0;168;52;13;J;29763
226000;0;0;2000;0;18800;0;0;1600;0;0;1600;160;0;0;160;52;26;C;112369
37988;0;0;2772;0;2772;0;0;1787;301;0;2088;168;0;0;168;52;19;C;149602
30251;0;26201;4050;0;2633;0;528;1664;332;0;1996;158;18;0;176;52;41;C;22971
30371;0;0;5095;0;2545;0;0;1431;440;67;1938;126;0;4;130;52;30;E;61795
25094;0;0;4972;0;1727;0;0;1472;616;0;2088;146;23;0;169;52;25;C;106378
22362;0;0;1765;0;1868;0;0;1732;248;0;1980;128;37;0;165;52;22;Q;162687
13896;528;0;1471;0;2263;0;0;728;152;0;880;168;0;0;168;22;8;G;65014
87352;0;0;4615;0;4615;0;0;1677;223;0;1900;143;22;0;165;52;27;K;64587
38566;0;1200;4332;0;2224;10;0;1703;218;45;1966;152;8;2;162;52;22;K;119053
40935;0;1659;1279;0;3676;199;0;1566;294;106;1966;173;0;18;191;52;31;C;166144
37442;0;0;4924;0;2712;237;0;1790;241;115;2146;160;8;14;182;52;23;M;16218
42750;0;0;4077;0;2961;0;0;1671;279;0;1950;133;22;0;155;52;28;K;14370
41194;32;2480;2860;0;3099;0;0;1673;359;0;2032;139;29;0;168;52;40;C;126050
38414;0;0;5541;0;2770;0;0;1586;284;0;1870;146;0;0;146;52;30;J;97329
34918;0;0;2964;0;2488;0;0;2272;52;0;2324;157;10;0;167;52;26;N;122481
34929;0;3691;3702;0;4220;179;0;1545;255;116;1916;119;31;6;156;52;30;K;113381
24931;0;0;2884;0;1817;333;0;1985;194;414;2593;145;26;33;204;52;31;G;179033
23787;0;0;4102;0;1724;0;46;1366;674;0;2040;129;33;0;162;52;31;C;56266
42729;0;0;4257;0;8536;20;0;1634;121;37;1792;128;0;6;134;52;32;C;104887
19909;0;0;1302;0;2160;0;0;1083;339;80;1502;168;0;0;168;32;14;C;153027
32678;0;1890;4742;0;2395;0;0;2035;305;0;2340;168;2;0;170;52;35;G;145523
14650;0;0;949;0;1526;265;0;1457;67;284;1808;173;0;31;204;36;0;N;80488
27342;0;0;3906;0;1953;0;0;2037;376;0;2413;168;0;0;168;52;21;N;131822
30226;0;0;4318;0;2159;0;0;1808;168;0;1976;152;0;0;152;0;21;M;47903
7604;0;0;0;0;1507;0;0;600;384;0;984;128;40;0;168;24;45;F;140711
36334;0;0;4466;0;2612;0;0;1587;453;0;2040;158;1;0;159;52;42;C;102911
37357;0;1790;5831;0;3207;0;0;1935;198;0;2133;159;15;0;174;48;22;M;17878
26213;0;0;3258;0;1816;54;0;1694;344;54;2092;152;0;4;156;52;24;C;99191
4317;0;0;291;0;1726;0;0;552;0;0;552;168;0;0;168;15;0;S;123719
15933;0;920;396;0;1212;0;51;1616;180;10;1806;125;0;0;125;52;27;H;180405
29108;225;24475;1;0;2119;1;0;1684;236;8;1928;155;10;1;166;52;25;G;159424
27917;0;0;1555;0;2466;235;0;1967;280;215;2462;168;0;21;189;52;280;C;130219
14207;0;0;1;0;1638;141;0;1309;0;106;1415;147;0;16;163;37;0;C;100307
35005;278;0;1962;0;3313;156;0;2088;194;180;2462;168;0;11;179;52;12;J;61312
32944;281;0;5295;0;2349;159;0;1856;232;67;2155;160;8;10;178;52;17;D;174908
21881;0;0;2987;0;1504;0;0;1779;254;15;2048;166;2;0;168;52;27;C;142283
23436;0;0;1708;0;1889;0;0;1632;91;0;1723;126;21;0;147;52;26;Q;93562
25704;1120;20727;3857;0;1928;118;0;1768;320;71;2159;160;8;8;176;52;33;C;70894
39496;416;29620;7408;0;2810;128;0;1656;314;52;2022;158;0;6;164;52;24;D;89456
20898;0;0;2882;0;1513;54;0;1575;241;37;1853;156;8;5;169;52;29;C;96323
26432;0;1598;2323;0;2041;0;0;NA;NA;NA;NA;NA;NA;0;NA;52;23;Q;182852
30859;0;0;2809;0;2195;0;0;1766;32;8;1806;153;10;0;163;52;24;C;66550
41022;1307;0;5172;0;2829;0;398;1581;265;4;1850;141;0;0;141;52;33;H;68932
18642;0;0;2484;0;1293;0;0;1615;248;0;1863;157;3;0;160;52;26;N;150516
64892;2229;0;5318;0;4604;0;0;1738;294;0;2032;168;0;0;168;52;36;M;44149
58820;0;0;8802;0;1044;604;0;1264;944;960;3168;184;0;80;264;52;118;H;75178
18564;0;0;1361;0;1579;143;535;1623;311;42;1976;159;9;14;182;52;31;C;117360
19485;0;0;3371;0;1671;0;0;1682;421;0;2103;144;24;0;168;52;20;C;52031
32167;0;0;5358;0;2679;119;0;1655;288;39;1982;157;9;7;173;52;21;H;85658
46842;0;0;6490;0;3270;0;0;1802;206;17;2025;156;4;0;160;52;24;J;88842
30870;0;0;7073;0;1876;192;56;1601;431;123;2155;151;17;14;182;52;17;F;182945
24515;0;0;3384;0;2065;0;0;1460;294;0;1754;151;0;0;151;51;22;N;37511
46981;0;0;5059;0;3200;585;0;1730;0;129;1859;165;33;0;198;0;21;C;176977
26073;0;0;3250;0;1717;42;3;1720;290;78;2088;118;56;4;178;52;29;G;32622
20909;0;0;2750;0;1528;0;0;1702;306;0;2008;156;13;0;169;52;47;H;106605
26343;1904;0;1838;0;1941;0;0;1921;223;0;2144;146;22;0;168;52;26;J;141578
33025;0;0;2620;0;2334;216;0;1439;689;246;2374;88;80;14;182;52;29;C;157377
37330;46;1549;7507;0;4211;186;0;1683;405;84;2172;142;29;11;182;52;19;J;85759
26544;0;0;2737;0;2063;143;0;1625;415;63;2103;136;32;11;179;52;31;C;141300
38942;0;0;5445;0;2723;0;0;1789;251;0;2040;159;9;0;168;52;26;M;21091
16487;0;15405;1082;0;2216;0;199;1049;65;0;1114;131;33;0;164;31;4;Q;75418
31626;1092;0;4260;0;2182;625;6;1734;138;561;2433;158;0;54;212;52;22;N;9366
24991;0;0;1857;0;5571;0;0;622;58;0;680;168;0;0;168;17;0;G;171140
NA;0;0;0;0;NA;0;0;1784;24;24;1832;168;0;0;168;0;19;C;59702
23344;0;0;1768;0;1736;0;0;1418;614;0;2032;155;13;0;168;52;23;C;139953
26773;0;0;3583;0;1950;14;0;1684;396;6;2086;164;4;1;169;52;36;C;62716
30122;0;0;2330;0;2397;170;231;1786;245;64;2095;150;9;12;171;52;19;C;147533
18843;0;0;1530;0;1415;0;0;1748;333;0;2081;160;8;0;168;52;25;C;176024
26154;0;0;1943;0;1592;73;0;1575;449;126;2150;123;45;6;174;52;18;C;137280
22663;0;0;1640;0;2403;0;0;1435;0;0;1435;151;0;0;151;36;12;C;126523
27412;0;0;3433;0;1826;0;0;1598;345;10;1953;154;7;0;161;52;22;J;48978
22156;0;0;1774;0;2101;0;0;1296;170;0;1466;168;0;0;168;38;15;N;91807
28928;0;25864;2979;0;2163;8;0;1563;238;32;1833;144;15;4;163;52;36;Q;32327
24083;0;0;3142;0;2018;0;0;1844;172;0;2016;168;0;0;168;52;14;N;34187
24791;22184;1862;0;0;1862;200;0;1733;275;204;1937;156;13;16;171;4;15;C;73079
20787;0;0;2983;0;1989;0;0;1383;148;0;1531;160;0;0;160;39;11;S;75062
203983;0;0;21436;0;10984;0;0;1683;224;0;1907;140;26;0;166;52;29;C;62609
35131;0;0;4642;0;2322;0;0;1748;157;175;2080;158;0;0;158;52;21;C;172700
9862;0;0;666;0;1054;0;0;1736;0;0;1736;192;0;0;192;45;20;C;143401
NA;0;0;0;0;NA;0;0;1760;272;220;2252;168;0;15;183;0;19;C;163545
15045;0;0;2838;0;1524;9;70;728;1300;41;2069;130;39;1;170;51;30;H;25915
26631;0;0;2108;0;1826;467;0;1648;437;574;2659;128;40;41;209;52;32;E;49
34287;144;0;6199;0;2294;0;0;1329;445;53;1827;131;26;0;157;52;43;M;88246
34346;250;0;5956;0;2225;109;0;1533;497;138;2168;138;83;12;233;52;24;C;179593
40524;0;0;4065;0;3536;0;320;NA;NA;NA;NA;NA;NA;0;NA;52;0;Q;93217
30753;0;0;5688;0;2172;0;0;1637;0;41;1678;141;0;2;143;52;17;H;108913
20938;0;0;1539;0;1448;0;0;1613;420;0;2033;144;24;0;168;52;22;C;61226
28383;46;620;5642;0;3020;0;0;1520;564;0;2084;144;24;0;168;52;35;J;85760
27639;0;0;4612;0;2390;0;389;1260;443;0;1703;144;24;0;168;52;17;C;29692
37912;20685;13634;3593;0;3283;0;150;1853;107;16;1976;168;0;0;168;52;22;F;86884
21149;0;0;1782;0;1762;154;0;1872;128;52;2052;156;8;11;175;52;29;E;101374
21490;0;0;3532;0;1825;213;0;1594;428;65;2087;163;2;14;179;52;19;H;59723
26108;0;0;2176;0;1864;0;0;NA;NA;NA;NA;NA;NA;0;NA;52;0;G;170971
18981;0;0;1110;0;1776;191;0;1771;261;211;2243;168;0;24;192;52;29;C;63352
54639;0;0;2371;0;6291;224;0;2087;212;150;2449;176;0;13;189;52;21;C;101975
20805;0;0;2998;0;1056;5;17;1583;351;0;1934;102;22;3;127;50;33;G;72349
2391;0;0;207;0;NA;0;0;232;0;2;234;NA;NA;0;NA;6;0;C;27883
69574;2215;75;7925;0;4660;0;0;1780;260;0;2040;168;2;0;170;52;28;H;167380
23133;0;0;1584;0;1584;57;0;1515;467;57;2039;165;0;5;170;52;30;G;96528
21966;0;0;1434;0;1691;257;0;1774;234;243;2251;168;0;23;191;52;21;C;13088
29692;0;0;3796;0;1658;0;0;1811;265;0;2076;168;0;0;168;52;29;C;30149
31200;0;0;2853;0;2250;55;194;1674;216;4;1894;126;30;4;160;52;36;Q;124492
27646;115;44;6556;0;2564;356;0;1642;433;139;2214;152;16;29;197;52;29;C;156845
36805;0;30199;6089;0;2688;231;57;1560;248;77;1885;143;8;24;175;52;26;K;103702
35976;0;0;6936;0;2507;0;0;1260;745;0;2005;153;9;0;162;52;27;H;101915
43800;0;0;6801;0;2920;0;0;1449;335;0;1784;168;0;0;168;52;29;C;69572
37426;0;0;2269;0;2774;0;0;1672;432;148;2252;168;0;4;172;52;42;F;17324
19693;0;0;2560;0;1476;148;0;1889;0;92;1981;167;0;15;182;52;14;C;123599
24942;0;0;4221;0;2033;0;0;1721;0;0;1721;147;0;0;147;52;25;K;70846
72837;299;0;15418;0;4769;0;0;1720;384;0;2104;148;20;0;168;52;45;H;118874
37072;0;1908;2854;0;3248;363;246;1029;476;60;1565;147;0;22;169;52;35;Q;182872
24954;0;0;3058;0;1787;0;0;1717;368;0;2085;172;0;0;172;52;37;C;106985
34397;0;0;5624;0;2531;311;0;1487;258;110;1855;139;12;19;170;52;28;C;120476
25807;0;900;3426;0;2013;0;0;1527;500;48;2075;106;58;0;164;52;27;H;71555
31630;0;0;4923;0;2285;0;28;2296;296;48;2640;176;91;0;267;52;34;G;45510
36405;0;0;4104;0;6459;258;0;1661;228;253;2142;146;17;16;179;52;23;K;18114
32526;0;203;2373;0;2353;0;0;1501;312;0;1813;123;0;0;123;52;45;Q;61922
30340;0;27768;2572;0;2427;809;146;2016;119;841;2976;182;0;88;270;52;17;N;161889
130292;0;0;9866;0;9866;0;0;1737;295;0;2032;160;0;0;160;52;36;B;161030
47282;0;0;3756;0;3597;0;0;1748;331;0;2079;174;0;0;174;52;34;C;128700
51853;0;0;3814;0;2169;262;0;960;1248;640;2848;184;0;80;264;52;156;H;75204
15587;0;0;1250;0;1199;0;0;2110;50;0;2160;180;0;0;180;52;15;R;59618
32795;0;0;891;0;4264;0;0;1663;224;2;1889;149;11;0;160;52;29;N;85674
26925;0;0;4502;0;2271;0;0;1722;237;45;2104;168;0;0;168;52;39;C;149939
29516;0;0;4000;0;2205;205;0;1830;2304;168;NA;166;183;15;NA;52;25;M;74855
25098;0;0;1;0;2138;0;0;1757;227;0;1984;160;0;0;160;52;22;F;84154
15876;0;0;1211;0;1211;0;0;1626;304;0;1930;152;0;0;152;52;22;Q;151651
35136;0;0;4646;0;2527;336;0;1795;127;15;1937;162;0;0;162;52;20;G;56890
61087;3483;0;12369;0;3549;0;0;1864;168;0;2032;173;0;0;173;52;13;N;104958
13771;0;0;1391;0;1388;190;0;1456;106;128;1690;152;20;22;194;52;12;I;98787
89338;22324;0;8095;0;4356;0;0;1728;407;0;2135;176;0;0;176;52;25;C;174317
33721;0;0;4534;0;2180;0;0;1664;241;277;2182;151;17;0;168;52;30;C;182137
22008;0;0;3144;0;1572;0;0;1639;441;0;2080;121;47;0;168;52;20;C;154304
20373;0;1256;1425;0;1476;0;283;1216;823;0;2039;128;48;0;176;52;31;C;2880
21168;0;0;3528;0;1764;117;0;1491;198;131;1820;157;0;9;166;48;22;E;65360
36628;0;0;4924;0;2610;145;0;1768;320;73;2161;160;8;8;176;52;27;N;126229
26487;0;0;1000;0;2082;0;0;1657;232;0;1889;157;0;0;157;52;31;K;148676
36392;0;0;4039;0;2759;0;0;1776;168;0;1944;176;0;0;176;52;21;H;44606
50150;0;0;776;0;3268;0;0;1735;322;0;2057;144;32;0;176;52;25;G;145635
38511;0;4132;2771;0;2771;0;0;1700;0;0;1700;166;0;0;166;52;30;C;161182
44801;0;0;6394;0;3198;0;0;1726;298;0;2024;136;32;0;168;52;23;G;123741
37444;0;2218;3848;0;2918;161;0;1186;833;188;2207;114;52;5;171;52;34;H;70138
45217;0;0;6723;0;3758;0;0;218;0;1;219;NA;NA;0;NA;0;30;K;70081
34224;0;0;4593;0;2296;0;0;1892;160;129;2181;208;0;40;248;52;15;G;52168
6537;0;0;931;0;2123;0;0;787;0;0;787;133;0;0;133;20;0;S;147168
22790;0;0;3720;0;1956;0;0;1634;288;20;1942;165;0;0;165;52;32;E;41676
27272;0;0;3896;0;1948;0;0;1560;0;0;1560;160;0;0;160;52;17;C;147593
15000;0;0;1200;0;1370;0;0;1700;156;0;1856;156;0;0;156;54;26;Q;5391
35838;0;0;5355;0;2463;121;0;1755;702;72;2529;154;58;10;222;52;41;H;4798
15431;0;0;1300;0;1350;0;684;1653;174;0;1827;144;0;0;144;52;29;Q;11462
21076;0;0;3045;0;1538;199;0;1841;303;248;2392;168;0;22;190;52;23;M;8834
62851;0;0;2145;0;4757;0;0;1888;152;0;2040;168;0;0;168;52;19;C;80132
17569;0;0;1273;0;1273;0;0;1743;277;45;2065;133;34;11;178;52;31;N;55398
36683;0;0;4607;0;2681;0;0;2010;328;0;2338;167;27;0;194;52;41;C;20036
19344;0;0;1488;0;1488;0;0;1543;259;0;1802;136;5;0;141;52;19;C;150725
20001;0;0;1977;0;1466;498;0;1705;424;26;2155;115;53;1;169;52;30;C;75714
160830;1196;0;31842;0;10017;0;0;1936;152;0;2088;168;0;0;168;52;96;B;122838
49951;250;0;4440;0;3404;0;0;1667;240;0;1907;150;7;0;157;52;31;K;92136
8808;0;0;404;0;2428;0;0;564;36;0;600;160;8;0;168;15;2;M;69189
29251;0;0;1788;0;2125;268;63;1529;294;58;1881;156;0;19;175;52;47;Q;43195
36780;0;0;2829;0;2509;0;0;1829;0;20;1849;151;0;3;154;52;32;Q;85115
27131;0;1732;1907;0;2072;0;0;1732;287;0;2019;163;5;0;168;52;33;C;117775
27421;0;0;4678;0;2069;37;0;1971;417;19;2407;176;64;3;243;52;15;H;120585
4077;0;582;129;0;256;0;0;659;741;0;1400;48;120;0;168;33;19;C;142760
28588;0;0;3278;0;2159;0;0;1553;305;0;1858;156;0;0;156;52;37;C;156584
33457;0;0;3642;0;2697;0;0;1897;0;0;1897;165;0;0;165;52;27;H;170722
13285;0;0;2356;0;1173;0;0;1936;0;0;1936;168;0;0;168;52;13;L;17377
13567;0;0;2112;2112;1184;0;0;1293;252;0;1545;120;16;0;136;52;31;S;141650
31063;60;0;5110;0;2169;0;0;1536;383;0;1919;117;36;0;153;52;35;K;167237
35268;0;1188;3989;0;2897;71;0;1534;270;53;1857;119;38;4;161;52;25;K;93436
11765;420;0;783;0;2079;0;0;752;125;0;877;168;0;0;168;22;15;F;148654
11302;0;0;678;0;1531;0;0;999;130;2;1131;151;39;0;190;26;11;H;173279
21224;0;0;2336;0;1712;0;38;1455;1761;0;3216;126;144;0;270;4;31;E;48264
20971;0;0;135;0;1623;49;0;1655;323;52;2030;165;0;5;170;52;21;Q;153324
22373;0;0;2909;0;1703;14;0;1775;289;0;2064;165;3;2;170;52;27;C;127159
31982;0;0;1960;0;2386;0;88;1552;535;0;2087;146;22;0;168;52;21;C;79271
28322;0;0;1;0;2981;247;0;1544;545;119;2208;168;0;16;184;52;15;F;40159
3851;0;0;537;0;1199;0;0;409;63;0;472;152;21;0;173;12;9;S;1360
47723;0;0;7741;0;2692;71;0;1582;447;61;2090;159;0;5;164;52;43;C;115761
12498;0;0;1;0;1738;0;0;1085;67;0;1152;160;0;0;160;33;21;F;162133
1408;0;0;117;0;1408;0;0;159;16;7;182;159;0;0;159;4;2;N;143895
34537;0;0;4934;0;2467;0;0;1412;301;0;1713;105;63;0;168;52;23;G;21776
37886;0;0;9317;0;2103;0;9;1896;192;0;2088;176;0;0;176;52;21;I;69010
32741;0;0;2606;0;2237;238;0;1828;212;246;2286;168;0;19;187;52;27;C;102419
31124;0;0;3382;0;2174;119;0;1605;572;89;2266;159;17;8;184;52;28;H;122612
48331;0;0;5581;0;3211;864;0;2507;385;943;3835;237;31;106;NA;52;37;H;108923
21493;0;0;1560;0;1612;0;0;1838;306;13;2157;166;2;0;168;52;21;C;141690
11368;0;0;852;0;1258;184;0;1327;98;64;1489;160;0;23;183;39;4;S;155537
39163;52;0;4594;0;2806;277;0;1649;382;169;2200;150;17;15;182;52;41;C;10808
29520;0;0;4023;0;2025;0;0;1841;246;0;2087;164;4;0;168;52;21;M;113974
24504;0;0;3623;0;1955;0;0;1699;333;63;2095;135;33;0;168;52;33;C;22226
93363;0;0;10137;0;5083;0;0;1692;343;0;2035;155;8;0;163;52;37;C;106198
17450;0;1406;521;0;1296;0;0;1768;303;7;2078;150;16;0;166;52;3;F;3070
33336;0;0;4077;0;2470;57;1093;1540;473;54;2067;131;37;4;172;52;29;C;178754
21022;18127;0;2895;0;1583;21;0;1780;236;27;2043;168;0;8;176;52;21;G;59435
26703;0;585;1950;0;2146;0;0;1638;0;0;1638;150;6;0;156;52;33;Q;140438
11513;0;0;1336;647;1158;0;0;1280;0;0;1280;173;0;0;173;32;0;I;161061
28773;0;0;2117;0;2162;130;0;1566;342;53;1961;143;18;8;169;52;35;K;49880
26381;0;0;4353;0;18356;165;0;1538;568;10;2116;1406;333;10;NA;52;34;C;26514
32912;0;213;4202;0;2341;0;0;2215;209;0;2424;202;0;0;202;52;26;H;62538
11228;0;0;1260;0;984;0;0;1035;456;0;1491;112;0;0;112;44;19;H;87895
52877;2200;0;5899;0;3603;0;0;1960;72;0;2032;168;0;0;168;52;9;C;157181
28166;0;0;5401;0;1840;0;0;1639;315;54;2008;149;20;0;169;52;26;E;184726
21082;0;1654;0;0;1583;0;0;1529;487;0;2016;148;10;0;158;52;20;C;46677
39624;0;0;4294;0;3316;0;0;1570;683;0;2253;134;34;0;168;52;21;C;23659
22613;0;0;2430;0;1643;0;0;1637;222;35;1894;131;33;0;164;52;23;C;73873
81592;1135;0;8029;0;6325;0;0;1616;296;0;1912;157;0;0;157;52;17;K;179409
33953;0;0;4576;0;2885;899;0;1645;250;619;2514;147;6;33;186;52;34;H;51402
28067;0;0;3335;0;2527;272;0;1800;72;87;1959;160;0;20;180;52;10;F;66358
53242;0;0;6912;0;3826;0;0;1736;259;0;1995;168;0;0;168;52;18;C;27204
28862;0;1874;0;0;2410;291;0;1856;288;170;2314;168;0;21;189;52;23;C;152893
79107;0;0;10119;0;2936;0;0;1856;312;0;2168;168;0;0;168;52;312;F;109391
17977;0;0;1645;0;1714;0;0;1044;570;0;1614;132;24;0;156;52;41;Q;29115
36139;0;6860;6181;0;2670;23;0;1660;428;6;2094;160;8;2;170;52;30;C;136914
28945;0;0;2064;0;2226;46;0;1673;440;32;2145;167;2;3;172;52;20;C;154682
27021;0;0;4640;0;1857;0;0;1727;301;0;2028;144;25;0;169;52;31;M;46986
14213;0;0;518;0;2012;33;0;1071;284;48;1403;130;27;2;159;35;12;Q;151831
27600;0;0;2300;0;2342;208;0;1920;0;0;1920;160;0;16;176;52;15;F;129388
31050;0;0;4064;0;2141;110;0;1175;940;151;2266;186;0;15;201;52;29;C;42527
57784;0;0;4431;0;3982;0;0;1804;228;0;2032;168;0;0;168;52;29;C;60474
24038;0;0;2995;0;1929;0;0;1920;0;0;1920;172;0;0;172;52;20;H;24850
15558;0;0;1449;0;1230;0;0;1735;29;32;1796;140;0;0;140;52;9;Q;17598
21129;0;0;4062;0;2031;0;0;1192;960;7;2159;104;44;0;148;52;37;F;152136
23139;0;0;3528;0;1973;0;0;1811;257;0;2068;164;8;0;172;52;22;I;74884
33332;0;0;4355;0;2545;91;0;1632;137;136;1905;138;22;6;166;52;21;K;20660
26761;0;0;3793;0;1909;0;0;1816;88;0;1904;168;0;0;168;52;20;C;5522
29863;0;0;4821;0;2151;0;0;1586;295;141;2022;157;18;15;190;52;28;E;64210
32492;0;0;5156;0;2195;0;0;1513;365;113;1991;142;8;22;172;52;24;E;95616
22748;0;0;2382;0;1509;0;0;1832;0;0;1832;127;41;0;168;52;26;G;113588
24445;0;4515;1379;0;2614;386;0;1764;157;348;2269;155;0;34;189;52;13;C;74917
38803;0;0;4830;0;2909;342;0;1969;156;167;2292;182;4;22;208;52;20;H;125824
28046;0;0;4297;0;1888;0;0;1702;329;75;2106;148;24;0;172;52;14;G;13353
31983;218;0;4390;0;2292;0;0;1594;311;10;1915;142;15;1;158;52;21;K;120648
25114;0;0;1573;0;1621;0;0;1555;362;61;1978;112;48;0;160;52;20;C;163881
21218;0;0;1418;0;1658;0;50;1566;252;0;1818;141;12;0;153;52;7;Q;72235
141539;0;0;20000;0;10000;0;0;1816;216;0;2032;164;12;0;176;52;26;M;45736
50399;0;40892;9507;0;3370;0;0;1724;316;2;2042;160;8;0;168;52;30;C;108192
35193;0;0;3884;0;3837;44;0;1651;311;58;2020;136;33;5;174;52;34;H;50834
23022;0;0;1;0;2784;391;0;1752;344;150;2246;152;0;24;176;52;16;F;3126
31359;0;0;5083;0;2190;0;0;1764;317;26;2107;163;4;0;167;52;32;C;125512
16948;0;0;3059;0;1412;0;0;2101;259;0;2360;160;38;0;198;52;18;H;90292
22179;93;0;1869;0;1669;0;0;1817;215;0;2032;168;0;0;168;52;24;C;33901
39874;0;0;1726;0;2937;0;0;1451;888;0;2339;147;63;0;210;52;29;H;44655
21356;0;0;1642;0;1642;0;0;1922;150;50;2122;160;0;4;164;52;25;Q;144851
23062;0;0;1489;0;1489;0;0;1713;327;0;2040;163;5;0;168;52;21;C;30583
56532;0;42793;6814;2000;3514;0;0;1630;237;162;2029;167;0;0;167;52;24;B;69275
23217;0;0;2558;0;1632;0;0;1656;216;3;1875;144;0;0;144;52;28;Q;62415
86075;0;70273;5557;0;6877;0;204;2363;266;0;2629;202;18;0;220;52;28;Q;24440
36594;0;0;3735;0;3426;62;0;1344;176;0;1520;162;0;2;164;52;22;J;53529
40765;923;0;4581;0;2837;0;0;1636;314;0;1950;146;11;0;157;52;33;K;174681
28296;0;0;5423;0;1887;0;0;1616;359;0;1975;158;6;0;164;52;20;C;139088
26879;0;360;3121;0;2030;85;0;1659;280;75;2014;147;14;7;168;52;38;E;184274
47665;0;0;7154;0;3381;0;0;1515;0;0;1515;156;0;0;156;52;40;M;155682
19669;0;0;1331;0;1461;0;130;1416;194;19;1629;163;2;0;165;52;33;Q;133950
19030;0;0;1577;0;1404;19;140;1529;234;116;1879;146;6;2;154;52;24;Q;136186
25706;0;0;1;0;2292;119;0;1893;188;56;2137;171;0;7;178;52;23;F;107061
47066;0;0;9764;0;3082;0;0;1726;314;5;2045;168;0;0;168;52;15;J;164923
21588;0;0;1749;0;1757;0;0;1777;354;8;2139;165;3;0;168;52;16;C;12275
29792;0;0;2680;6362;2060;0;0;1819;169;0;1988;163;0;0;163;52;21;H;126616
12922;0;0;150;0;NA;0;0;920;1136;0;2056;0;168;0;168;52;0;F;86925
19500;0;0;1493;0;1518;0;0;1680;275;0;1955;137;16;0;153;52;30;J;177893
56628;0;0;3924;0;4387;0;0;1824;322;0;2146;134;28;0;162;52;32;M;128379
23491;0;0;1761;0;1811;0;0;1596;254;0;1850;148;6;0;154;52;30;Q;156048
88240;0;0;17330;0;5952;0;0;1796;232;0;2028;161;0;0;161;52;15;C;44847
31992;0;0;2808;0;3421;51;0;1506;386;103;1995;136;8;25;169;52;20;C;156960
47070;0;0;5859;0;3130;645;0;1873;196;497;2566;183;0;42;225;52;29;H;52111
18386;0;0;1532;0;1532;0;0;1920;160;0;2080;176;0;0;176;52;22;C;158088
69195;0;55007;9950;0;4827;0;0;1739;244;0;1983;111;46;0;157;52;24;D;43031
14825;0;0;1219;0;1153;0;0;1556;130;0;1686;150;6;0;156;47;20;C;16353
36429;0;0;2832;0;2589;349;0;1741;388;211;2340;115;52;19;186;52;21;C;169377
25478;0;0;1512;0;2364;0;0;972;1060;4;2036;164;4;0;168;52;34;C;157614
24331;0;0;4006;0;1702;0;0;1458;539;1;1998;126;38;0;164;52;30;J;128020
22115;0;1394;1947;0;1719;0;0;NA;NA;NA;NA;NA;NA;0;NA;52;37;M;182890
30257;0;0;521;0;2802;164;0;1608;526;143;2277;157;11;12;180;52;28;F;5968
21507;1109;0;3418;0;1457;0;0;1709;395;0;2104;168;0;0;168;52;34;N;147340
19987;0;0;1046;0;1611;0;0;1663;136;21;1820;173;4;0;177;47;20;G;13481
32866;294;0;9061;0;NA;0;0;983;983;9;1975;0;168;0;168;52;25;H;161981
25020;0;0;2771;0;1891;133;0;1821;266;105;2192;157;11;10;178;52;25;C;148043
26922;0;0;3714;0;1862;0;339;1557;331;27;1915;140;4;0;144;52;27;C;27153
18847;258;0;2800;0;1471;0;23;1487;321;46;1854;158;19;0;177;52;24;I;153042
25787;0;232;2803;0;1836;80;0;1680;435;64;2179;163;5;6;174;52;38;C;77507
52869;0;9611;6064;0;3863;0;0;932;0;0;932;101;6;0;107;52;37;H;185066
19387;0;0;2304;0;1723;0;0;1477;341;6;1824;173;0;0;173;52;23;C;114543
32357;0;1375;13887;0;2645;88;0;1663;324;143;2130;168;0;4;172;52;21;C;29021
20709;0;0;1438;0;1516;0;0;1531;542;0;2073;136;39;0;175;52;38;C;173034
17726;0;0;1020;0;1881;0;0;1092;208;0;1300;144;14;0;158;39;26;Q;151804
24041;0;0;1705;0;1692;24;0;1775;257;144;2176;128;40;2;170;52;20;C;98223
18902;0;0;1;0;1877;225;0;1772;131;712;2615;169;0;19;188;52;0;C;123586
23466;0;20447;1708;0;2179;42;0;1263;504;16;1783;142;0;3;145;52;27;Q;33641
30185;0;0;2799;0;1549;0;0;1542;236;5;1783;141;6;0;147;52;27;C;175631
13361;0;0;0;0;869;0;0;276;1452;0;1728;96;72;0;168;42;0;C;150606
24616;0;0;1325;0;1846;0;19;1710;378;63;2151;143;25;0;168;52;26;C;93481
41458;0;0;5796;0;2898;0;0;1981;259;0;2240;170;0;0;170;52;22;Q;15570
9991;0;0;680;0;1292;0;0;1486;0;0;1486;208;0;0;208;32;16;S;114864
36307;0;760;6837;0;2479;0;236;1646;425;15;2087;158;10;0;168;52;23;C;130638
28034;0;0;3042;0;1457;0;0;1801;223;22;2046;168;0;0;168;52;16;J;91222
37993;0;2903;1718;0;2640;0;0;1472;490;0;1962;166;0;0;166;38;31;M;103804
55600;0;0;4460;0;4460;0;0;1800;40;0;1840;168;0;0;168;52;25;C;3459
43581;0;5858;2196;0;2963;0;0;1764;316;0;2080;144;24;0;168;52;30;C;84387
52112;0;5693;6789;0;3149;0;0;1629;400;13;2042;152;8;0;160;52;21;C;69301
121648;1610;0;38923;0;6923;0;0;2277;155;0;2432;208;0;0;208;52;19;S;56390
18909;0;490;1703;0;1382;0;0;1173;903;0;2076;140;33;0;173;52;20;C;3680
28442;0;0;5745;0;1950;62;0;1616;548;33;2197;168;12;8;188;52;47;C;68475
71790;0;0;9772;0;4905;0;0;1572;479;0;2051;163;16;0;179;52;24;C;106239
11654;0;0;333;0;1208;0;0;1668;0;0;1668;168;0;0;168;44;0;H;94820
33340;0;0;2548;0;2548;0;0;1787;309;0;2096;166;2;0;168;52;15;J;54017
27827;0;0;1791;0;2168;148;0;1803;248;91;2142;164;4;11;179;52;31;C;157360
31073;0;0;1;0;2849;345;0;1808;0;207;2015;168;0;24;192;52;20;F;8794
35785;0;0;2354;0;3385;655;375;1067;756;402;2225;144;12;51;207;52;36;Q;75883
56289;0;0;18130;0;3220;0;0;1688;336;0;2024;176;0;0;176;52;39;C;81930
55090;0;0;6450;0;3470;230;0;2016;398;244;2658;176;72;8;256;52;30;H;81651
23128;0;0;2622;0;1693;0;0;1660;325;20;2005;147;13;0;160;52;20;Q;128542
26478;0;0;3643;0;1959;0;0;1684;153;10;1847;144;8;0;152;52;19;E;145271
24680;0;0;4086;0;2043;0;0;1730;302;0;2032;168;8;0;176;52;30;J;15742
23247;0;21797;1450;0;1700;12;0;1824;216;3;2043;166;2;2;170;52;23;C;160456
19299;0;0;1465;0;1466;0;0;1748;182;0;1930;152;0;0;152;52;21;Q;151659
28122;0;1063;1842;0;2337;215;248;1658;402;51;2111;128;40;18;186;52;33;C;119624
58106;0;4530;4191;0;7251;0;0;1565;235;0;1800;143;7;0;150;52;30;K;109899
42516;0;1779;516;0;3856;291;175;1801;287;154;2242;168;0;21;189;52;31;C;142748
32307;0;0;1;0;2692;0;0;1744;300;0;2044;144;24;0;168;52;20;J;30422
26612;0;0;2946;0;2038;22;0;1725;363;34;2122;157;11;1;169;52;24;C;62739
47092;565;41004;2295;0;3340;0;0;1647;225;0;1872;156;0;0;156;52;34;N;36765
23888;0;1935;1935;0;2030;324;46;1740;243;179;2162;167;1;27;195;52;19;C;181913
20138;0;0;1294;0;2207;13;15;1088;903;3;1994;166;7;1;174;52;21;Q;122199
19833;0;0;1446;0;1547;50;0;1673;339;37;2049;150;18;4;172;52;7;C;165399
39222;0;27251;3651;0;2574;0;219;1606;247;75;1928;143;18;5;166;52;40;Q;24683
60734;0;0;7121;0;NA;0;0;1769;53;239;2061;152;16;0;168;52;6;C;164357
87195;1041;0;5000;0;15000;0;0;632;48;0;680;168;0;0;168;17;8;F;74796
44888;0;0;10326;0;2874;0;0;1533;260;0;1793;138;12;0;150;52;27;B;108289
16438;0;0;931;0;1630;0;0;1842;102;21;1965;160;8;0;168;52;18;C;39186
25235;0;0;1622;0;2044;0;174;1772;308;50;2130;118;50;0;168;52;28;C;65128
35790;0;30175;5255;0;2640;0;225;1573;258;0;1831;153;6;0;159;52;36;Q;93305
23861;0;0;3091;0;1726;155;0;1580;384;171;2135;143;23;23;189;52;31;G;5447
22400;0;0;3200;0;1600;0;0;1800;201;0;2001;145;25;0;170;52;16;J;49897
35000;0;0;1;0;2500;0;0;2076;264;0;2340;176;0;0;176;52;33;C;42607
42671;0;32023;7391;0;2810;0;127;1595;324;16;1935;159;11;0;170;52;31;J;55910
37394;0;0;4778;0;2644;0;0;1888;152;0;2040;168;0;0;168;52;19;C;98174
24426;0;0;2044;0;1655;0;0;1928;160;0;2088;168;0;0;168;52;5;J;64663
30369;639;0;4372;0;2186;0;0;1648;112;11;1771;140;0;0;140;52;18;J;163120
33980;0;0;5208;0;2620;0;0;2089;357;515;2961;183;30;54;267;52;24;H;108946
17064;0;0;1495;0;1255;7;0;1557;509;174;2240;124;39;1;164;52;33;H;89803
34884;0;23371;11513;0;2179;177;0;1488;331;31;1850;135;15;9;159;52;25;K;23132
36327;0;0;3358;0;2907;357;0;1689;296;368;2353;155;8;27;190;52;35;H;183487
22578;0;2251;3164;0;2005;0;0;1612;391;0;2003;144;20;0;164;52;20;C;162199
20915;0;0;2878;0;1508;0;35;1579;445;53;2077;127;47;0;174;52;41;G;37757
38847;0;0;103;0;2667;16;0;1773;227;8;2008;157;11;1;169;52;21;C;139545
22198;0;0;1700;0;1700;0;0;1514;342;0;1856;101;64;0;165;52;27;Q;29783
24717;0;0;3534;0;1767;0;0;1801;327;0;2128;159;9;0;168;52;17;N;16889
38520;0;0;5073;0;3390;460;0;1740;300;289;2329;159;9;25;193;52;33;M;75680
26067;0;0;10;0;2134;0;0;1710;152;14;1876;149;8;0;157;52;20;F;128924
21034;1313;1127;3770;0;1945;186;0;1786;340;97;2223;168;0;15;183;52;21;B;165890
65352;4323;0;12958;0;4013;0;0;1789;299;0;2088;118;58;0;176;52;28;M;54229
15197;0;0;380;0;1801;368;0;1541;0;115;1656;163;0;33;196;44;0;C;100305
26807;0;2077;3104;0;2134;100;0;1767;223;60;2050;156;1;6;163;52;27;C;136210
32336;0;428;2373;0;2477;89;0;1561;320;81;1962;148;3;9;160;52;30;Q;172445
17217;0;0;2881;0;1382;0;0;1425;600;0;2025;135;33;0;168;52;37;C;167310
28298;1648;378;3220;0;2211;0;302;1291;552;0;1843;125;30;0;155;52;29;H;136318
21256;0;0;2158;0;2011;254;0;1239;801;134;2174;160;8;20;188;52;12;C;89997
41128;1214;25607;5890;0;2748;174;391;1616;168;193;1977;151;26;11;188;52;7;D;22463
16140;0;0;1105;0;1207;116;0;1896;192;123;2211;168;0;14;182;52;18;N;24145
47806;0;0;7499;0;2146;195;338;1792;224;52;2068;151;9;12;172;52;28;C;137716
82758;0;0;5384;0;5384;0;0;2040;0;0;2040;168;0;0;168;52;31;J;73794
19710;0;0;2836;0;1410;0;0;1810;0;0;1810;155;10;0;165;52;10;S;73761
26595;0;0;3675;0;1848;24;5;1544;336;52;1932;124;49;2;175;52;40;H;92052
21682;0;0;1541;0;1582;0;0;1824;290;0;2114;168;0;0;168;52;12;C;45896
78322;0;0;11148;0;5478;0;0;1864;216;0;2080;160;0;0;160;52;27;C;31167
29140;0;0;4513;0;1964;0;18;1347;180;0;1527;108;40;0;148;52;21;I;19128
25588;0;0;3832;0;1701;0;0;1608;480;0;2088;149;19;0;168;52;33;N;83291
41103;0;0;6496;0;2804;0;0;1693;351;0;2044;145;27;0;172;52;23;M;21244
53713;0;39322;14391;0;3305;0;0;1820;220;0;2040;158;10;0;168;52;26;J;177174
60093;0;0;4582;0;4582;0;0;1667;365;0;2032;128;40;0;168;52;42;C;8963
26294;0;0;7348;0;1562;0;0;1757;184;48;1989;141;18;0;159;51;23;D;31571
29030;0;0;4424;0;1964;0;0;1524;198;80;1802;138;18;0;156;52;26;E;73684
5443;0;0;459;0;723;0;0;1016;128;0;1144;168;0;0;168;29;16;C;79762
28474;0;0;1763;0;1763;0;0;1785;247;0;2032;158;10;0;168;52;25;C;39766
40369;0;0;2075;0;1865;0;0;1840;236;127;2203;167;6;0;173;52;17;C;120972
26127;0;0;0;0;2084;0;0;2080;0;0;2080;173;0;0;173;4;22;C;32147
28968;0;0;3871;0;1994;213;0;1782;306;101;2189;148;23;20;191;52;21;M;163916
NA;0;0;0;0;NA;0;0;1624;8;453;2085;128;0;45;173;0;22;C;59682
29134;0;0;4699;0;2775;0;0;1033;904;0;1937;120;56;0;176;46;14;C;97677
47353;77;1684;6127;0;3034;0;0;1713;249;0;1962;161;6;0;167;52;16;D;55740
21757;0;0;3050;0;1525;0;0;1770;340;0;2110;159;3;0;162;52;32;J;153643
53638;1491;30800;6172;0;3868;603;0;1766;345;180;2291;176;0;0;176;52;24;M;121074
21931;0;0;1640;0;1540;0;0;1783;257;106;2146;168;0;0;168;52;32;C;55626
37828;0;0;5575;0;1930;57;0;1542;473;75;2090;159;8;22;189;52;37;C;6403
21231;0;0;1708;0;1691;0;0;1572;436;0;2008;166;2;0;168;48;29;C;35607
20120;0;0;1965;0;1504;0;0;1715;404;8;2127;168;0;0;168;52;18;C;95797
33847;1264;0;2452;0;2559;0;0;1780;252;0;2032;160;8;0;168;52;32;C;169000
41201;0;0;5167;0;2824;183;0;1746;283;106;2135;160;8;9;177;52;24;C;118364
116784;0;0;35203;0;6064;0;0;1824;264;0;2088;168;0;0;168;52;27;C;134305
24699;353;0;2751;0;1834;0;1834;2096;296;47;2439;184;0;0;184;52;37;C;117738
27499;0;0;9779;0;2192;195;0;1522;294;66;1882;138;12;11;161;52;29;E;51461
60054;0;0;10898;0;4294;0;0;1597;435;0;2032;152;16;0;168;52;29;C;3627
8045;0;236;474;0;1569;145;0;730;7;45;782;168;0;12;180;18;5;C;142915
29154;0;0;1626;0;2646;190;0;1840;191;137;2168;164;0;16;180;52;16;C;109039
33515;0;0;2314;0;2655;381;0;1566;230;236;2032;149;0;23;172;52;32;Q;128595
39963;0;0;5503;0;2777;250;0;1738;294;207;2239;138;30;15;183;52;34;C;49603
9887;0;0;922;0;804;0;0;1523;485;49;2057;149;0;0;149;52;20;S;159203
8484;0;0;425;0;2998;645;0;645;64;190;899;173;8;64;245;18;8;C;133722
52244;0;0;12643;0;3268;0;0;1616;365;0;1981;149;10;0;159;52;43;L;103610
39193;0;0;4600;0;2342;0;0;1760;368;0;2128;168;0;0;168;52;25;M;45488
35305;0;0;4786;0;2458;0;0;1630;402;12;2044;160;8;0;168;52;28;C;57872
19742;0;0;1212;0;1751;0;0;1840;264;0;2104;168;0;0;168;52;20;G;3501
20441;0;0;1387;0;1587;200;0;1828;204;195;2227;164;4;20;188;52;25;C;121505
28001;0;635;3806;0;2246;76;942;1596;492;10;2098;166;2;8;176;52;28;C;164649
29077;0;2735;6612;0;2423;0;0;1817;215;0;2032;158;10;0;168;52;14;C;167718
26918;0;720;3530;0;2056;455;0;1704;296;345;2345;152;16;39;207;52;29;C;172742
24118;0;0;5302;0;1699;0;0;744;1229;0;1973;0;164;0;164;52;7;H;69887
19375;0;0;1427;0;1654;0;0;1397;635;12;2044;165;3;0;168;46;23;B;32586
78196;0;0;6701;0;10065;0;0;1716;300;0;2016;164;12;0;176;52;37;M;147911
24093;0;352;3905;0;1853;0;0;1745;293;0;2038;128;40;0;168;51;26;C;72311
23837;0;0;4316;0;1655;0;0;1716;321;3;2040;143;25;0;168;52;33;C;112576
25580;0;23249;2331;0;2033;0;0;1635;272;0;1907;149;1;0;150;52;23;N;85656
18971;0;0;3066;0;1239;0;29;1209;201;0;1410;126;16;0;142;52;20;I;19122
22585;0;0;1745;0;1705;0;0;1816;303;3;2122;168;0;0;168;52;25;C;129977
29640;0;0;2538;0;1698;11;0;1267;809;14;2090;168;5;1;174;52;20;C;126115
52775;0;0;6346;0;3460;0;0;1628;322;0;1950;157;0;0;157;52;30;K;136950
21753;0;0;2316;0;1632;0;0;1513;566;27;2106;154;10;0;164;52;30;C;94259
30133;0;947;2028;0;2202;59;65;1760;320;35;2115;152;8;5;165;52;34;C;79497
25000;0;0;5500;0;1500;100;0;1700;190;30;1920;150;20;5;175;52;26;G;154945
22364;0;0;13;0;1645;0;0;1735;353;0;2088;151;1;0;152;52;18;J;37384
97880;0;0;11938;0;7938;0;0;1864;224;0;2088;168;0;0;168;52;14;C;58003
50317;0;0;3841;0;3893;198;0;1834;522;228;2584;168;17;17;202;52;9;C;10638
14659;0;0;1350;0;1515;80;323;1705;337;25;2067;132;30;7;169;52;34;S;140104
17471;0;0;1;0;1447;0;0;1871;0;1;1872;153;0;0;153;48;0;G;108102
46468;0;0;6637;0;3069;253;0;1674;280;83;2037;153;4;13;170;52;28;D;95500
61964;0;0;4247;0;4247;0;0;1936;176;0;2112;176;0;0;176;52;22;J;29134
7274;0;0;923;0;1895;0;0;632;27;0;659;132;24;0;156;16;2;H;185288
23800;0;0;2964;0;1708;115;0;1792;322;149;2263;176;0;10;186;52;28;G;120004
29402;0;27561;1841;0;1927;0;0;1641;180;0;1821;165;0;0;165;52;20;Q;84521
20835;0;0;2976;0;1447;0;0;1776;135;31;1942;136;32;0;168;52;16;G;26597
25831;0;0;4302;0;1935;109;0;1288;528;40;1856;104;64;9;177;52;29;H;1070
15032;0;0;1176;0;963;0;0;1646;234;63;1943;124;8;0;132;52;22;C;13489
31622;0;2897;6725;0;2913;274;0;1760;328;339;2427;168;0;26;194;52;18;C;73045
29861;0;3724;2035;0;2399;0;0;1668;372;0;2040;162;0;6;168;52;28;C;170309
84854;0;0;6567;0;6527;0;0;1743;207;0;1950;150;0;0;150;52;27;K;145759
35290;0;27632;7658;0;2587;0;257;1632;207;0;1839;117;36;0;153;52;38;Q;103122
43027;26794;12455;3778;0;3621;570;0;1846;122;372;2340;168;0;40;208;52;21;F;86874
15438;0;0;1545;0;1339;0;0;1515;375;0;1890;143;22;0;165;52;25;Q;11873
18500;0;0;5029;0;1542;0;0;1880;144;8;2032;168;0;0;168;52;18;J;40062
35653;0;25667;4700;0;NA;396;198;1656;173;41;1870;151;0;24;175;52;24;Q;85361
58636;0;0;6210;0;3855;0;0;1593;287;0;1880;142;15;0;157;52;36;K;66620
84717;0;0;5716;0;5470;0;0;1894;194;0;2088;168;0;0;168;52;17;C;16997
49610;0;0;6028;0;4023;0;0;1698;14;0;1712;152;0;0;152;52;1;C;150263
19749;0;0;1030;0;1564;0;0;1672;0;0;1672;158;0;0;158;45;6;C;76532
31129;0;0;2786;0;2969;0;0;1631;318;5;1954;161;0;0;161;52;29;E;65286
43355;0;864;3849;0;2762;0;0;1498;300;16;1814;115;43;0;158;52;45;H;143221
26901;0;0;3029;0;2220;0;0;1920;0;20;1940;168;0;0;168;52;15;B;130807
31345;0;0;2079;0;2058;43;0;1659;291;98;2048;157;0;5;162;52;18;K;133657
22294;0;0;3041;0;1877;0;0;1433;264;0;1697;144;8;0;152;51;20;N;37471
45945;2010;7438;5493;0;3163;380;0;1502;65;46;1613;145;0;13;158;52;5;K;184864
33529;0;0;4528;0;2525;260;0;1664;334;85;2083;136;35;15;186;52;22;G;156122
21000;0;0;1;0;1800;0;0;1900;200;100;2200;176;0;0;176;52;25;C;42598
20616;0;0;1607;0;1647;0;0;1872;233;0;2105;156;0;0;156;52;29;R;44538
18422;0;0;1785;0;1528;0;0;1589;258;0;1847;132;12;0;144;52;33;Q;130047
5463;0;0;262;0;1399;0;0;256;16;0;272;168;0;0;168;52;2;C;17388
38350;0;0;7170;0;3508;0;0;1688;446;27;2161;145;23;0;168;52;38;F;150857
95524;0;0;7928;0;7928;0;0;1232;242;0;1474;118;7;0;125;52;27;Q;24513
20240;0;679;2838;0;1524;0;29;1648;123;12;1783;154;0;0;154;52;15;H;84687
35306;0;31006;4300;0;2562;68;305;1477;343;31;1851;145;7;4;156;52;44;Q;33657
14900;0;0;1000;0;1150;0;0;1615;70;0;1685;170;0;0;170;52;20;C;43968
34644;2280;0;4836;0;2418;0;0;1720;168;0;1888;168;0;0;168;4;20;C;16097
8127;0;0;544;0;1731;0;0;725;84;8;817;725;84;8;NA;20;6;N;41396
26071;0;22517;3554;0;1816;0;0;1595;375;0;1970;147;3;1;151;52;32;Q;154568
38304;0;1563;1620;0;3215;434;293;1912;207;499;2618;168;0;32;200;52;14;C;156683
28369;0;0;2976;0;1940;0;0;1872;NA;NA;NA;136;32;0;168;0;21;M;83891
33340;0;122;2108;0;2351;0;279;1516;228;55;1799;137;0;5;142;52;36;Q;168854
41258;2946;0;5894;0;2946;0;0;1471;43;0;1514;162;0;0;162;52;58;H;135607
29801;0;0;6178;0;2292;0;0;1591;330;28;1949;141;15;0;156;52;22;K;163306
18768;0;1240;2391;0;1379;0;0;1792;391;0;2183;160;0;0;160;52;19;Q;135293
27219;0;0;1420;0;2096;0;0;1463;472;0;1935;120;44;0;164;52;33;C;117127
28501;0;0;1839;0;2022;0;0;1501;261;0;1762;137;6;0;143;52;35;N;425
29294;0;0;3830;0;1915;0;0;2016;34;52;2102;168;0;0;168;52;19;C;103727
31073;0;2284;3122;0;2392;145;2247;1689;291;34;2014;160;0;8;168;52;25;C;67148
40956;0;917;3395;0;2998;225;77;1588;263;303;2154;133;32;17;182;52;22;H;143232
17588;0;0;1800;0;1800;0;0;1030;1058;0;2088;0;168;0;168;52;34;C;99773
15932;0;0;1416;0;1579;0;0;1310;165;4;1479;152;0;0;152;44;24;C;32550
24975;0;0;3721;0;1780;80;0;1852;236;99;2187;168;0;8;176;52;25;G;143258
24582;0;0;1603;0;2042;0;0;1578;246;0;1824;156;0;0;156;52;31;C;33906
26020;0;0;2768;0;1940;0;0;1639;188;10;1837;132;24;0;156;52;31;E;85879
20310;0;0;1416;0;1825;428;0;1847;297;148;2292;168;0;37;205;52;20;C;141699
17686;0;0;2527;0;1263;0;0;1762;265;7;2034;131;44;0;175;52;31;N;164096
39635;0;0;3557;0;3407;0;0;1698;350;0;2048;168;0;0;168;52;33;C;135336
17622;0;0;2063;0;1375;0;0;1562;470;0;2032;158;10;0;168;52;16;J;69982
24566;0;0;1817;0;1900;0;266;1640;294;0;1934;128;0;0;128;52;28;C;84759
40307;0;0;4400;0;2984;0;0;1665;423;0;2088;173;3;0;176;52;38;M;44804
24266;0;0;1714;0;1714;0;0;1589;459;11;2059;152;16;0;168;52;13;C;29825
28301;1264;0;2338;0;2238;485;0;1703;275;1150;3128;137;29;70;236;52;31;N;142830
29967;0;0;2109;0;2288;0;0;1537;311;0;1848;145;27;0;172;52;39;Q;100141
49528;0;0;5774;0;3166;0;193;1572;300;25;1897;102;54;0;156;52;21;J;146083
3800;0;0;293;0;1174;0;0;427;76;0;503;147;0;0;147;13;0;Q;62881
37253;0;0;2307;0;2307;0;0;1764;356;8;2128;158;10;0;168;52;23;E;90761
19639;0;0;2870;0;1636;0;148;1494;419;0;1913;147;9;0;156;52;34;C;38024
20929;0;0;4633;0;1774;0;0;1688;0;0;1688;138;0;0;138;52;32;F;44520
16747;0;0;2775;0;1220;0;0;1653;337;39;2029;147;0;0;147;51;19;H;61341
17826;0;0;1765;0;1265;135;0;1529;361;177;2067;101;32;13;146;52;23;H;40562
30900;0;0;2066;0;2407;304;0;1603;520;189;2312;128;40;17;185;52;21;C;77129
56571;0;0;4069;0;4711;0;0;1751;296;0;2047;148;20;0;168;52;33;C;185213
19963;0;0;2714;0;1241;0;0;1869;0;0;1869;148;15;0;163;52;10;M;50156
28302;0;0;2358;0;2010;0;0;2000;310;0;2310;208;8;0;216;52;26;M;152694
3117;0;0;3117;0;3117;0;0;NA;NA;NA;NA;NA;NA;0;NA;4;20;J;177375
34524;0;0;4932;0;2466;0;0;1799;0;0;1799;168;0;0;168;52;17;G;179004
24472;0;0;6038;0;6038;0;0;1308;324;0;1632;144;0;0;144;52;33;C;180071
12272;0;3318;3318;0;1653;0;0;1423;236;0;1659;123;18;0;141;52;26;G;47874
20677;345;0;4197;0;1467;136;0;1752;340;55;2147;144;24;13;181;52;26;H;159844
20112;0;0;2892;0;1825;86;71;1554;466;24;2044;155;9;0;164;52;3;C;164840
22490;0;0;3189;0;1634;0;0;1747;0;56;1803;128;40;0;168;52;33;C;94111
25183;0;0;2;0;1945;0;0;1667;407;17;2091;164;4;0;168;52;26;H;9422
28336;0;0;3383;0;2109;323;0;1716;300;273;2289;168;0;26;194;52;29;G;13841
22208;0;634;3093;0;1622;0;19;1524;162;125;1811;156;0;0;156;52;18;G;83786
37980;0;0;2697;0;2909;0;0;1363;377;102;1842;134;9;0;143;52;28;Q;171678
25002;26;0;4668;0;1694;0;0;1623;332;10;1965;124;0;0;124;52;26;G;119500
36691;0;0;2767;0;2789;0;0;1767;308;0;2075;144;24;0;168;52;31;C;108648
25424;0;0;1824;0;1823;18;0;1924;102;25;2051;168;0;2;170;52;12;C;46753
16023;0;0;5132;0;1593;0;0;1034;1133;20;2187;180;10;0;190;52;19;G;70062
51759;0;0;4614;0;4250;0;0;1856;232;0;2088;162;6;0;168;52;13;C;153226
46775;0;0;1;0;2110;0;0;1432;600;0;2032;173;0;0;173;52;10;J;105163
36802;0;0;2967;0;2568;0;0;1800;232;0;2032;148;20;0;168;52;27;J;50911
236852;3057;0;18492;0;18492;0;0;1776;400;0;2176;168;0;0;168;52;40;C;110178
37635;570;0;5051;0;2525;0;0;1736;342;0;2078;127;41;0;168;52;30;J;42761
19095;0;1312;240;0;1447;0;14;1884;95;0;1979;158;7;0;165;52;26;Q;161143
41571;0;0;1106;0;3212;0;0;1332;136;0;1468;108;0;0;108;52;17;H;34401
NA;0;0;0;0;3499;0;0;NA;NA;NA;NA;156;12;0;168;0;0;C;34070
29095;0;0;1801;0;1801;0;0;1622;363;203;2188;152;8;0;160;52;37;G;96519
24605;0;0;2421;0;2030;0;0;1650;210;0;1860;108;48;0;156;52;35;Q;104656
19256;0;0;174;0;1469;0;0;1628;236;0;1864;150;24;0;174;52;15;C;37087
6873;0;253;454;0;1787;135;0;537;45;31;613;166;0;10;176;16;3;N;49468
33717;0;429;2373;0;2328;0;141;1741;181;123;2045;157;0;0;157;52;29;Q;172476
29020;0;0;1938;0;2174;0;0;1571;0;0;1571;149;0;0;149;52;27;C;66818
40717;0;0;8996;0;2617;0;0;1744;314;0;2058;168;0;0;168;52;31;M;62977
28568;0;0;1128;0;1893;0;379;1728;137;239;2104;144;16;0;160;52;16;C;182480
29149;25314;0;3835;0;2005;0;0;1752;328;25;2105;142;26;0;168;52;26;G;144363
58775;0;0;9961;0;5225;0;0;1785;303;0;2088;168;0;0;168;52;22;G;44880
24659;0;0;3411;0;1884;0;0;1706;326;9;2041;168;0;0;168;52;17;C;164859
33472;0;0;1981;0;3630;1068;0;2160;0;1125;3285;240;NA;125;NA;39;0;H;9230
18533;0;0;1240;0;1405;0;50;1697;279;0;1976;126;44;0;170;52;33;Q;129282
16062;0;0;1200;0;1200;0;0;1745;183;8;1936;143;0;0;143;52;18;Q;12264
80800;610;59161;21029;0;5035;0;0;992;707;20;1719;124;29;0;153;52;20;K;185138
26154;0;0;4634;0;1792;115;0;1652;453;126;2231;164;4;10;178;52;24;M;156277
26249;0;0;2416;0;2526;201;0;1721;311;145;2177;165;3;16;184;52;12;F;16798
25894;0;0;1839;0;1638;0;0;1485;516;0;2001;156;0;0;156;52;17;Q;106157
44223;0;0;6879;0;2420;0;501;1532;442;3;1977;166;10;0;176;52;30;C;137704
11528;0;0;1;0;1066;0;0;768;16;0;784;103;49;0;152;28;10;F;87181
29361;0;0;3692;0;2130;0;0;1547;416;15;1978;144;26;0;170;52;27;G;83565
75655;0;0;1787;0;6351;0;0;1234;911;0;2145;112;81;0;193;52;29;H;92553
28170;0;0;3486;0;1861;0;43;1958;248;0;2206;161;19;0;180;52;32;H;173179
34913;0;0;3932;0;2377;101;0;2015;65;22;2102;166;0;6;172;52;26;C;42811
52370;0;0;5926;0;3813;0;0;1622;268;0;1890;158;0;0;158;52;35;K;167640
19620;0;0;1437;0;1483;46;0;1603;429;147;2179;156;12;5;173;52;20;C;98234
24256;0;0;1834;0;2150;0;0;1295;842;7;2144;165;3;0;168;52;29;C;12509
100000;0;0;0;0;NA;0;0;NA;NA;NA;NA;NA;NA;0;NA;52;0;I;12578
14002;0;0;2334;0;1132;0;0;1955;173;0;2128;172;0;0;172;52;22;S;64122
38947;0;0;4669;0;2948;0;0;1612;292;0;1904;157;1;0;158;52;30;K;79335
28430;0;0;1964;0;2474;430;0;1840;254;185;2279;156;12;30;198;52;26;J;177871
14832;0;0;1513;0;1756;0;313;1128;464;0;1592;128;40;0;168;52;22;C;98386
8050;0;0;2950;0;1555;0;0;635;0;3;638;105;0;0;105;19;0;Q;164833
26542;0;0;2180;0;2280;0;0;1613;475;0;2088;168;0;0;168;52;30;B;74136
25861;0;22612;3249;0;1854;0;0;1483;203;0;1686;151;0;5;156;50;27;Q;33978
92327;0;11805;10142;0;5865;0;0;1858;120;0;1978;160;8;0;168;52;18;F;2826
13685;0;0;0;0;1559;0;0;1010;142;0;1152;120;0;0;120;35;0;C;26127
21275;0;0;1226;0;4234;1157;0;1160;0;580;1740;240;0;120;360;21;14;H;9231
59048;0;0;4102;0;5121;0;0;1792;240;0;2032;160;8;0;168;52;30;S;42619
50141;0;4890;4230;0;3086;0;0;2024;264;0;2288;168;6;0;174;52;32;G;145503
23736;0;0;3106;0;1611;171;12;1288;577;94;1959;99;75;15;189;52;46;R;83284
16940;0;1140;0;0;1538;222;0;1322;207;109;1638;130;2;22;154;0;0;N;23295
35643;0;0;2316;0;3099;101;60;1419;547;29;1995;134;34;15;183;52;40;C;4411
30515;0;0;4229;0;2115;0;0;1514;345;0;1859;154;11;0;165;52;31;C;62596
9766;0;0;1302;0;1302;0;0;NA;NA;NA;NA;92;80;0;172;52;15;C;47996
44101;0;0;4534;0;3274;0;0;1716;315;21;2052;160;7;0;167;52;36;C;116141
28676;0;26778;1898;0;1991;0;0;1614;213;187;2014;131;15;0;146;52;25;Q;84479
43112;0;0;4268;0;3034;0;0;1607;268;2;1877;153;5;1;159;52;23;K;87476
19870;0;0;1394;0;1630;0;174;1443;310;0;1753;150;0;0;150;52;23;C;132917
35689;0;27270;4140;0;2545;0;266;1448;700;29;2177;144;18;1;163;52;34;Q;154565
26149;0;0;2341;0;2075;211;300;1747;281;106;2134;169;8;19;196;52;35;C;155116
16266;28;0;1635;0;350;0;0;1014;1074;0;2088;0;168;0;168;52;7;C;106357
32700;0;0;2808;0;2787;0;0;1434;75;0;1509;101;54;0;155;52;34;K;163046
24100;0;0;3442;0;1721;49;0;1597;483;117;2197;121;48;5;174;52;19;C;121648
16899;0;0;1416;0;1416;0;0;1784;238;0;2022;160;0;0;160;52;26;C;95730
59297;2391;6829;1062;0;3409;0;0;1880;208;0;2088;168;0;0;168;52;20;C;116186
20003;0;0;1;0;1765;0;0;1756;144;0;1900;160;0;0;160;52;25;F;18328
30419;1049;148;5222;0;2173;0;0;1630;269;2;1901;158;0;0;158;52;27;D;123458
73302;168;0;3754;0;4118;0;0;1840;192;0;2032;144;0;0;144;52;14;C;82336
33669;0;2138;2138;0;2548;0;163;1711;202;0;1913;154;14;0;168;52;26;Q;32232
3875;0;0;131;0;1360;0;0;360;128;0;488;144;0;0;144;52;0;I;73746
27019;0;0;3852;0;1926;49;0;1764;370;36;2170;140;28;4;172;52;30;G;45085
39548;0;0;3042;0;NA;0;0;1595;309;0;1904;157;0;0;157;52;30;K;138739
9192;0;0;653;0;1759;192;0;693;163;88;944;152;16;17;185;22;20;C;138988
28810;0;0;4116;0;2074;16;0;1872;12;1;1885;144;12;1;157;52;2;E;22125
25953;0;0;2817;0;2932;0;146;1573;463;0;2036;128;16;0;144;52;21;C;152397
39458;0;0;3961;0;2501;0;0;1826;0;0;1826;168;0;0;168;52;27;I;106557
25561;0;0;1470;0;2049;25;219;1741;291;47;2079;168;0;2;170;52;18;C;84160
23782;0;0;1;0;1807;0;0;1688;336;4;2028;173;0;0;173;52;39;J;105149
16954;0;0;1366;0;1299;0;0;1719;217;4;1940;159;0;0;159;52;17;N;67183
23997;0;0;2076;0;1688;95;0;1703;277;90;2070;163;0;8;171;52;35;H;178391
5314;0;0;461;0;1597;0;0;444;84;0;528;160;8;0;168;13;7;C;48733
34718;0;0;2583;0;2569;0;0;1686;199;5;1890;141;14;0;155;52;19;K;20621
48763;0;0;3577;0;3577;0;0;1748;292;0;2040;160;8;0;168;48;35;C;114081
28649;0;19284;5040;0;1838;0;231;1194;632;2;1828;152;0;0;152;52;16;C;81391
21545;0;0;1615;0;1601;0;0;1753;39;0;1792;155;0;0;155;52;14;F;129330
28964;0;0;274;0;1531;0;0;1830;250;197;2277;128;46;0;174;52;27;C;96553
17436;0;0;1400;0;1453;0;0;1856;160;0;2016;159;9;0;168;48;20;N;60673
33809;0;29146;4663;0;2378;244;0;1637;267;218;2122;154;3;19;176;52;26;K;147951
65000;0;0;4642;0;4642;0;0;2088;0;0;2088;168;0;0;168;52;31;N;117072
34666;0;2385;3289;0;2942;396;2453;1712;310;76;2098;160;8;18;186;52;23;C;67237
17466;0;0;2911;0;1447;0;0;1726;264;24;2014;133;49;0;182;52;26;G;76251
32623;0;0;6539;0;2342;134;0;3115;326;290;3731;140;15;13;168;52;30;K;157291
17208;0;0;1302;0;1404;0;0;1852;180;9;2041;150;10;0;160;52;21;C;143028
25409;0;0;3479;0;1844;0;0;1734;377;24;2135;168;0;0;168;52;24;C;75530
35554;0;760;6747;0;2362;0;0;1637;436;0;2073;132;36;0;168;52;25;C;130644
NA;0;0;1816;0;1682;0;0;1816;224;12;2052;165;3;0;168;52;20;C;108839
21053;0;0;1177;0;1624;0;0;1754;286;230;2270;161;7;0;168;52;14;C;132487
13408;0;0;1028;0;1139;0;0;1727;294;0;2021;160;0;0;160;52;23;E;12595
26443;457;0;1738;0;2333;63;0;2088;316;63;2467;168;16;5;189;52;28;J;65777
26445;0;0;3841;0;2024;0;0;1683;404;8;2095;168;0;0;168;52;15;E;136104
22820;0;0;2285;0;1700;0;0;1721;231;0;1952;168;0;0;168;51;29;C;172730
33628;0;0;4421;0;2403;0;0;1654;254;8;1916;150;8;1;159;52;21;K;133070
17754;0;0;2072;0;1544;111;0;1423;401;146;1970;173;40;8;221;48;20;C;114542
46004;0;0;3636;0;3517;0;0;1696;360;0;2056;167;1;0;168;52;40;C;91711
35044;831;852;2682;0;2927;0;0;1360;1048;0;2408;148;28;0;176;51;54;J;45353
20760;0;0;1945;0;1570;0;0;1686;346;0;2032;168;0;0;168;52;43;J;163530
NA;0;0;0;0;1279;0;0;NA;NA;NA;NA;168;0;0;168;0;0;N;15666
37345;0;0;4596;0;2698;172;0;1538;266;100;1904;134;14;10;158;52;36;Q;35014
24207;0;21914;2293;0;1910;0;0;1633;228;0;1861;149;0;0;149;52;20;N;85655
38581;0;0;2001;0;2415;413;0;1752;284;249;2285;154;14;26;194;52;280;C;78110
23805;0;0;3354;0;1677;0;0;1512;440;0;1952;152;12;0;164;52;29;C;171930
33631;0;0;4066;0;2681;10;0;1670;318;9;1997;169;0;1;170;52;49;H;89302
3370;0;0;100;0;3370;0;0;160;0;0;160;160;0;0;160;4;0;J;168273
30597;0;0;4537;0;2136;0;0;1761;104;0;1865;156;0;0;156;52;8;E;48496
40190;0;0;4595;0;2839;0;0;1729;221;0;1950;150;7;0;157;52;26;K;147372
29856;1146;148;5562;0;1995;0;0;1636;227;1;1864;138;15;0;153;52;23;D;88773
44190;0;0;4191;0;4109;1232;394;1092;1136;847;3075;126;48;90;264;52;88;H;8916
25431;0;0;3942;0;1517;0;0;1299;625;0;1924;121;40;0;161;52;20;C;62828
18928;0;0;2355;0;1481;0;0;1486;632;0;2118;152;16;0;168;52;20;C;65016
19389;17915;0;1474;0;1474;0;0;1436;192;0;1628;128;0;0;128;4;22;S;43704
131519;708;17403;29310;0;11823;0;0;1558;322;61;1941;135;22;7;164;52;36;L;128148
22976;0;0;3836;0;1918;0;0;1808;328;0;2136;168;0;0;168;52;26;C;135021
19763;0;0;1094;0;2037;343;0;1690;300;63;2055;147;0;26;173;52;28;C;2943
23790;0;0;1830;0;1830;0;0;1632;400;0;2032;158;6;0;164;52;29;J;116343
18991;0;0;2713;0;1356;0;0;1927;187;0;2114;168;0;0;168;52;15;K;59633
21674;21674;0;1806;98;1806;0;0;1821;255;0;2076;167;6;0;173;52;20;C;10971
22236;0;0;3224;0;1566;0;0;2112;164;0;2276;162;20;0;182;52;26;S;59606
28585;0;0;2661;0;1838;81;0;1743;280;168;2191;166;2;6;174;52;35;F;165728
31016;0;0;2385;0;2385;0;0;1836;240;0;2076;160;0;0;160;52;22;J;14222
35978;0;0;4110;0;2484;0;0;1544;316;13;1873;150;0;6;156;52;31;K;66634
26305;0;0;1877;0;2209;0;0;1570;135;1;1706;157;0;0;157;47;18;K;104402
20688;0;0;1632;0;1561;0;113;1511;223;0;1734;144;0;0;144;52;27;C;33908
17377;0;0;2997;0;1455;0;0;1557;483;4;2044;168;0;0;168;52;15;C;5269
7775;0;0;452;0;3530;0;0;504;0;3;507;144;0;0;144;12;0;J;61322
35690;0;0;6964;0;2419;175;0;1516;341;70;1927;148;5;12;165;52;12;K;29707
18053;0;0;2969;0;1501;0;0;1560;372;42;1974;160;6;0;166;52;30;G;32486
37140;0;0;6190;0;2652;0;0;1915;0;0;1915;159;0;0;159;52;0;H;45987
29304;0;0;2442;0;2672;230;0;1717;247;79;2043;143;19;12;174;52;31;J;102472
21472;0;0;1565;0;1580;0;0;1739;294;0;2033;148;20;0;168;52;20;C;138851
54934;60;0;8084;0;3424;0;0;1611;308;0;1919;141;12;0;153;52;25;K;84978
67400;0;0;10896;0;4510;0;0;1675;232;0;1907;157;0;0;157;52;27;K;59367
36952;0;27385;9567;0;2289;0;0;1649;257;203;2109;158;0;0;158;52;29;N;127998
23298;0;0;1885;0;1906;0;831;1407;384;71;1862;122;36;12;170;52;55;Q;172819
14094;0;0;818;0;1410;0;0;1136;79;0;1215;160;12;0;172;35;5;H;131910
33587;0;0;2;0;2302;0;0;1625;358;0;1983;138;34;0;172;52;24;H;78234
67102;0;0;8885;0;5095;0;0;1641;183;0;1824;156;5;0;161;52;22;C;92261
70000;0;0;5384;0;5384;0;0;1613;0;0;1613;125;0;0;125;52;41;K;61216
12351;0;0;1200;0;1350;0;0;900;0;0;900;168;0;0;168;40;0;B;39231
4585;0;0;599;0;1624;279;270;294;49;71;414;167;0;31;198;12;2;N;75606
38156;0;0;5020;0;2620;7;471;1523;307;0;1830;126;25;1;152;52;20;N;72466
34205;0;0;412;0;2417;0;0;1772;316;0;2088;160;8;0;168;52;30;R;15028
21581;0;0;3009;0;1514;0;0;1756;351;29;2136;152;16;0;168;52;25;Q;156153
83995;0;5165;8403;0;5948;0;107;2566;136;0;2702;245;0;0;245;52;18;Q;144683
6027;0;0;0;0;849;0;0;798;0;0;798;112;0;0;112;37;0;R;73372
22387;0;1368;1506;0;2190;0;223;1888;171;17;2076;144;24;0;168;51;9;C;34619
55744;0;0;4288;0;4288;0;0;1976;0;0;1976;182;0;0;182;52;32;Q;140945
23017;0;0;2553;0;1714;0;0;1774;370;39;2183;152;16;0;168;52;28;E;110716
15495;0;0;1227;0;908;0;0;1768;264;0;2032;128;0;0;128;52;22;C;114172
21984;0;0;2720;0;1515;106;0;1802;341;78;2221;160;8;8;176;52;17;H;34442
31762;0;0;2440;0;2440;0;0;1642;433;6;2081;142;26;0;168;52;26;J;32820
22437;0;0;2772;0;1463;57;0;1601;357;219;2177;146;14;6;166;52;26;N;63241
59653;65;11120;8361;0;3391;0;0;1780;320;0;2100;175;0;0;175;52;33;C;127318
23283;0;0;3076;0;1659;0;0;1800;264;0;2064;168;0;0;168;52;20;C;58421
57462;0;0;3355;0;3666;179;0;1527;385;131;2043;117;40;8;165;52;22;K;33551
35000;0;0;2692;0;2692;0;0;1870;162;0;2032;160;8;0;168;52;20;J;53615
24666;0;2000;2881;0;1680;47;0;1572;536;64;2172;116;49;4;169;52;41;N;3057
23512;0;0;1790;0;4755;0;0;1824;208;0;2032;168;0;0;168;52;26;C;14345
39874;0;0;2873;0;2873;0;0;1980;0;0;1980;157;0;0;157;52;31;K;100972
29626;0;0;3682;0;2082;0;0;1718;164;261;2143;157;0;0;157;52;19;C;131771
22900;0;0;1713;0;1760;0;0;1567;413;0;1980;140;25;0;165;52;26;Q;162665
35787;0;0;4257;0;2226;0;422;1727;173;112;2112;160;8;0;168;52;27;D;57461
20101;0;0;14;0;1356;0;0;1856;172;101;2129;168;0;3;171;52;18;R;38921
23219;0;20285;2934;0;1771;12;173;1594;426;43;2063;168;0;8;176;52;35;C;102907
59023;0;0;0;0;4872;0;0;1992;104;0;2096;168;0;0;168;52;5;F;88226
17306;0;0;1632;0;1516;227;0;1760;128;150;2038;168;0;23;191;0;16;C;173418
25000;0;0;2;0;1755;0;0;1588;436;0;2024;158;8;0;166;52;34;C;122105
30536;0;0;1618;0;2274;0;0;1723;294;15;2032;151;6;2;159;52;24;H;67914
38072;0;0;1;0;3407;272;0;2016;106;168;2290;168;0;19;187;52;0;C;151099
38864;0;0;5552;0;2776;0;0;2027;265;0;2292;217;0;0;217;52;17;K;74540
35634;0;0;5702;0;2388;0;0;1867;197;0;2064;166;6;0;172;52;16;R;111419
28028;102;0;2687;0;2106;0;0;1527;337;0;1864;135;33;0;168;52;21;C;98351
31855;0;775;1689;0;NA;576;0;1705;327;617;2649;168;0;42;210;52;28;C;114443
NA;0;0;0;0;NA;0;0;NA;NA;NA;NA;151;17;16;184;0;0;C;138214
16656;0;0;0;0;1491;0;0;1248;440;0;1688;165;3;0;168;52;37;C;161124
16553;0;0;1358;0;1249;0;129;1614;279;0;1893;138;13;0;151;52;35;C;45460
4808;0;422;422;0;2079;0;0;576;0;0;576;144;0;0;144;16;6;J;29804
16062;0;0;1394;0;1291;0;0;1638;272;0;1910;151;0;0;151;52;32;R;46906
21753;0;0;2650;0;1586;0;0;1786;296;40;2122;164;4;0;168;52;18;N;72572
10860;0;8749;2111;0;1799;45;0;864;69;21;954;138;12;6;156;26;10;Q;33419
11533;0;0;894;0;1619;213;0;1041;143;83;1267;168;0;21;189;29;18;C;148620
6768;0;0;530;0;1139;0;0;870;78;0;948;168;0;0;168;28;5;N;47646
24129;0;1735;1250;0;1816;0;0;1650;438;5;2093;141;27;0;168;52;18;C;154743
29869;0;0;3647;0;2049;130;0;1754;262;228;2244;128;40;11;179;52;27;G;13838
23725;0;0;1334;0;1334;0;0;1635;295;37;1967;144;15;0;159;52;26;Q;160921
38188;0;0;5129;0;2673;0;0;1676;282;32;1990;135;23;0;158;52;27;G;132592
25881;0;0;3352;0;1843;0;0;1608;30;143;1781;137;19;0;156;52;26;E;76386
20400;0;0;1;0;1700;0;0;1667;439;29;2135;146;22;0;168;52;30;C;123418
70298;1291;49805;18914;0;4189;0;0;1656;320;0;1976;120;38;0;158;52;24;D;59895
16635;0;0;1;0;1312;0;0;1300;788;9;2097;128;40;0;168;52;18;F;52518
21352;0;0;1751;0;2379;273;0;1602;365;131;2098;160;0;20;180;52;16;B;179814
20654;0;0;2462;0;1612;0;0;1742;346;0;2088;165;3;0;168;52;20;C;170913
28071;0;0;1983;0;1983;0;0;1511;512;0;2023;149;14;0;163;52;43;R;174410
17718;0;0;1361;0;1482;43;0;1678;378;76;2132;208;0;4;212;52;20;S;134117
146573;2671;12182;12182;0;14615;0;0;1528;40;0;1568;128;40;0;168;43;5;C;41718
19132;0;0;2877;0;1490;0;0;1729;268;8;2005;167;1;0;168;52;22;H;49760
18889;0;0;1453;0;1453;0;0;2496;0;0;2496;160;8;0;168;52;25;C;85709
32041;0;0;6367;0;2169;0;0;1698;240;0;1938;147;10;0;157;52;26;E;67804
2480;0;0;194;0;NA;0;0;216;112;0;328;NA;NA;0;NA;8;14;C;41893
19725;0;0;1517;0;1517;0;0;1623;402;0;2025;123;45;0;168;52;21;C;36478
22663;0;0;1458;0;1996;0;0;1608;52;0;1660;160;0;0;160;52;22;R;527
23531;0;0;5233;0;1982;0;26;1376;146;10;1532;123;0;0;123;52;29;H;66421
21109;0;0;2202;0;1299;0;0;1569;515;0;2084;127;41;0;168;52;34;C;68971
28172;0;3600;3086;0;2139;131;0;1842;208;97;2147;166;2;11;179;52;19;H;20011
45016;0;0;3964;0;3420;0;0;1500;302;22;1824;157;0;0;157;52;22;K;171264
31768;26845;4083;840;0;2532;441;0;1721;367;89;2177;164;4;25;193;52;33;C;22361
34971;0;0;8727;0;2315;0;0;1630;396;34;2060;168;0;0;168;52;45;G;84872
26215;0;0;1812;0;2019;0;0;1549;282;0;1831;123;33;0;156;52;47;Q;101457
12741;0;0;721;0;2063;86;0;950;111;51;1112;168;0;9;177;26;9;C;160913
24510;0;22336;2174;0;1968;0;0;1732;172;60;1964;152;16;0;168;52;20;F;2831
33835;1194;0;6306;0;2245;0;6;1554;377;0;1931;151;14;0;165;52;22;J;108713
40481;78;0;7434;0;2691;0;0;1497;317;3;1817;107;33;0;140;52;20;K;31561
NA;0;0;14;0;1314;7;0;1730;310;40;2080;160;8;3;171;52;22;M;25223
3647;0;0;280;0;1232;0;2;575;0;0;575;181;0;0;181;15;0;N;91312
17290;0;0;1441;0;1441;145;0;1696;3;43;1742;168;0;14;182;52;34;C;114791
29636;0;0;2469;0;2213;253;0;1607;302;318;2227;151;1;19;171;52;24;G;26541
96391;0;6940;6940;0;6876;0;0;1250;266;325;1841;133;0;48;181;52;42;Q;103189
18285;0;0;1343;0;1599;295;0;1867;165;42;2074;168;0;28;196;52;20;C;37724
31936;0;3871;1826;0;2784;0;343;1699;372;10;2081;162;6;0;168;52;30;C;11220
17377;0;0;2460;0;1209;0;0;1514;142;0;1656;136;0;0;136;52;8;N;17939
27917;0;0;2116;0;2296;0;0;1749;282;0;2031;168;0;0;168;52;15;C;148411
NA;0;0;0;0;3129;0;0;NA;NA;NA;NA;162;1;0;163;0;0;C;73956
26645;0;1572;1620;0;2182;87;62;1588;498;91;2177;143;26;6;175;51;34;C;156695
18243;0;0;1051;0;1535;0;0;1718;162;0;1880;168;0;0;168;48;105;B;13618
36681;0;0;6049;0;2761;287;87;1670;356;241;2267;144;24;18;186;52;25;C;88446
49587;0;0;3272;0;3319;0;0;1640;384;0;2024;156;8;0;164;52;26;J;109927
19502;0;0;1281;0;1954;344;0;2047;220;219;2486;168;0;36;204;52;27;C;132013
23469;0;0;5880;0;2033;0;0;1545;348;0;1893;125;24;0;149;52;17;N;122352
29457;0;0;1887;0;2230;245;0;1670;297;103;2070;144;24;16;184;52;26;C;174014
33142;0;0;4026;0;2367;0;0;1744;273;20;2037;145;20;0;165;52;29;J;128045
26533;0;0;1936;0;2591;0;0;1956;40;60;2056;168;8;0;176;51;12;C;6379
213258;0;36091;83404;0;10765;0;0;1468;440;0;1908;159;0;0;159;52;51;H;134061
32366;0;0;5422;0;2250;0;0;1776;248;0;2024;168;0;0;168;52;31;N;5526
16022;0;0;1027;0;3166;273;0;960;240;52;1252;152;12;20;184;30;12;C;105741
39588;639;0;3655;0;2586;239;0;1941;210;548;2699;160;8;19;187;52;28;G;172001
13886;0;0;2000;0;NA;0;0;704;241;0;945;NA;NA;0;NA;31;21;C;7560
49308;0;0;8440;0;3776;0;0;1680;0;13;1693;135;0;0;135;52;22;K;71367
5670;0;62;443;0;1363;0;0;319;59;0;378;172;1;0;173;9;0;C;12350
50401;0;0;13450;0;3106;66;0;929;912;27;1868;138;6;3;147;52;21;K;130696
26194;0;0;3763;0;1887;0;0;1638;284;0;1922;151;17;0;168;52;20;F;122636
25271;0;0;3303;0;1727;0;18;1553;463;49;2065;127;41;0;168;52;29;G;146120
20375;0;0;3839;0;1622;80;0;1748;284;33;2065;168;0;7;175;52;28;E;25254
16372;0;0;2325;0;1167;0;0;1714;338;0;2052;173;0;0;173;52;25;N;17112
11781;0;0;1117;0;3515;237;28;888;84;266;1238;153;14;27;194;26;12;N;147841
25442;0;0;2987;0;1944;0;0;1620;395;0;2015;134;34;0;168;52;47;C;34155
20768;0;0;1494;0;1699;205;0;1804;2220;86;NA;161;187;19;NA;52;18;C;58469
68908;0;0;8460;0;4230;0;0;1741;299;0;2040;160;8;0;168;52;37;G;156119
35361;0;0;5187;0;2722;288;0;1759;281;119;2159;164;4;16;184;52;35;C;101997
21760;0;0;3155;0;1617;0;0;1707;205;0;1912;162;0;0;162;52;19;C;30135
36923;0;0;5843;0;2657;0;0;1562;640;0;2202;120;16;0;136;52;21;I;82040
36197;13860;2912;3532;0;2128;28;0;1250;442;137;1829;138;11;15;164;48;31;M;185103
29011;0;0;3110;0;2150;0;176;1667;420;0;2087;154;14;0;168;52;24;C;106230
7556;0;0;472;0;1755;0;0;600;99;13;712;165;7;0;172;18;14;C;32565
25183;0;1579;1579;0;1689;260;0;1523;509;185;2217;136;31;25;192;52;26;C;69015
17467;0;0;2735;0;1685;0;119;667;1469;0;2136;153;27;0;180;52;39;R;53857
17842;0;0;1365;0;1368;0;0;1775;249;26;2050;163;5;0;168;52;20;C;107793
6064;0;0;548;520;NA;0;0;475;338;38;851;NA;NA;0;NA;31;20;M;152961
18151;0;0;1247;0;1412;59;0;1835;165;94;2094;168;0;5;173;50;15;N;57720
23216;0;0;3177;0;1283;0;0;1968;386;0;2354;164;45;0;209;52;20;Q;174131
45839;0;0;3278;0;3337;0;0;1808;216;0;2024;168;0;0;168;52;25;J;109913
30181;0;0;10075;0;3033;82;0;1696;387;27;2110;159;16;4;179;52;40;C;180667
6830;0;0;527;0;NA;0;0;106;692;0;798;NA;NA;0;NA;22;12;C;152945
60841;0;0;5070;0;3907;651;0;1800;248;350;2398;208;8;32;248;52;3;M;152680
36228;0;0;4334;0;2537;0;0;1677;339;13;2029;154;16;0;170;52;42;C;81915
29722;0;0;2502;0;2252;0;0;1528;417;0;1945;128;35;0;163;52;47;C;86100
27216;0;0;6592;0;2492;0;49;1685;124;10;1819;151;0;0;151;52;21;Q;117886
33135;0;24925;8210;0;2405;0;206;1613;180;0;1793;155;0;0;155;52;30;Q;128666
26404;0;0;5458;0;1747;0;0;1632;206;117;1955;152;7;12;171;44;27;R;25407
33492;0;0;6000;0;2435;0;0;1302;738;0;2040;133;35;0;168;52;83;J;134141
28656;0;0;3511;0;2095;0;0;1743;345;0;2088;144;32;0;176;52;26;M;44893
29840;0;0;2165;0;2917;50;0;1731;374;85;2190;168;15;3;186;52;33;C;170876
25098;160;0;4626;0;1593;8;0;1604;348;34;1986;113;48;0;161;52;27;E;99445
60545;0;0;3806;0;4449;0;0;2052;257;0;2309;124;44;0;168;52;27;H;44684
25084;0;0;1760;0;1960;0;0;1590;480;0;2070;160;7;0;167;52;24;G;104526
14070;0;0;880;0;1759;0;0;883;122;0;1005;163;0;0;163;26;14;C;83943
22157;0;0;2892;0;1649;0;0;887;1191;0;2078;112;56;0;168;52;25;C;158206
25305;0;0;2646;0;1740;0;0;1912;280;0;2192;128;40;0;168;52;29;H;61339
55757;398;27960;6965;0;4560;347;1617;1525;554;121;2200;128;40;16;184;52;24;D;39722
NA;0;999;999;0;NA;0;0;2076;0;0;2076;173;0;0;173;52;20;C;76016
50400;0;0;3991;0;4980;0;0;1576;512;0;2088;160;8;0;168;52;54;G;95019
29185;0;0;4401;0;2262;0;0;1419;406;83;1908;128;23;8;159;52;22;K;167150
34887;0;0;6224;0;2355;66;0;1654;382;52;2088;147;16;4;167;52;32;C;140607
28455;0;0;4501;0;2209;0;0;1602;198;128;1928;143;8;8;159;52;19;K;119117
9866;0;0;2285;0;1302;0;0;233;1803;0;2036;115;50;0;165;52;28;C;101635
31215;0;4755;3504;0;2238;0;0;1465;377;0;1842;143;16;0;159;52;34;Q;93262
66103;0;145;1054;0;4600;0;0;1628;217;0;1845;139;0;0;139;52;29;K;105305
29628;0;0;2625;0;2417;0;0;1703;276;39;2018;165;4;4;173;52;30;C;49191
126644;0;0;19392;0;9046;0;0;NA;NA;NA;NA;NA;NA;0;NA;52;29;C;45128
26778;0;0;2112;0;2472;0;0;1805;162;0;1967;161;14;0;175;52;21;C;139719
49871;0;0;5326;0;4078;917;174;1830;258;622;2710;168;0;53;221;52;16;C;36923
29269;0;0;3806;0;1953;182;0;1479;345;233;2057;103;55;12;170;52;29;G;104133
51292;0;0;8705;0;3918;0;0;1600;0;41;1641;142;0;0;142;52;33;K;87273
22780;0;0;1720;0;1824;92;0;1779;246;38;2063;170;0;8;178;52;246;C;130211
24600;0;0;2946;0;2031;0;0;1196;280;0;1476;155;19;0;174;36;18;M;25051
39289;0;3640;2240;0;3004;438;0;1823;217;227;2267;164;4;30;198;52;20;C;143320
41094;0;0;3158;0;3134;0;0;1688;225;0;1913;158;0;0;158;52;30;K;180912
50888;0;0;5209;0;3793;0;0;1787;301;0;2088;176;0;0;176;52;27;C;156595
35395;0;0;5056;0;2528;0;0;1832;208;8;2048;168;0;0;168;52;21;R;74929
28305;0;0;1899;0;2213;314;0;1693;442;229;2364;188;1;21;210;52;23;J;148464
18490;0;0;1;0;1422;1;0;1920;200;0;2120;160;20;1;181;52;28;S;118932
24892;0;0;2;0;1779;0;0;2064;0;0;2064;172;0;0;172;52;18;I;40657
32084;0;0;3184;0;1991;0;0;1636;0;338;1974;127;0;0;127;4;17;M;92475
32594;0;0;0;0;2405;0;0;856;1184;0;2040;88;80;0;168;52;20;C;35878
35781;0;0;2329;0;2581;0;0;1885;167;28;2080;160;8;0;168;52;18;J;65894
27645;0;0;3838;0;1898;0;0;2268;0;0;2268;113;64;0;177;52;15;H;150625
37105;0;0;6126;0;3079;0;0;1799;0;0;1799;133;43;0;176;52;27;K;16771
21980;0;0;3000;0;1540;36;0;2087;364;85;2536;172;40;4;216;52;26;H;32887
66685;0;0;8713;0;6219;0;0;1649;254;0;1903;150;7;0;157;52;34;K;68668
5110;0;0;388;0;1186;67;0;657;53;63;773;165;6;9;180;18;7;N;90424
5158;0;364;338;0;2068;0;0;468;0;0;468;148;0;0;148;13;0;N;40838
44235;0;0;1459;0;3561;200;0;1714;326;200;2240;152;16;19;187;52;25;N;103090
35333;9660;3311;4428;0;2309;0;0;1567;279;25;1871;148;3;0;151;48;26;M;185114
151475;0;0;26233;0;10030;0;0;1792;232;0;2024;168;0;0;168;52;24;J;30642
71962;0;0;9501;0;5804;191;573;1225;0;0;1225;119;0;0;119;52;41;J;5771
26237;0;0;1836;0;1903;57;0;1881;156;30;2067;166;2;5;173;52;20;C;1547
31950;0;0;1340;0;3680;682;0;1306;163;505;1974;168;0;69;237;52;20;N;157920
19037;0;0;1366;0;1584;0;0;1698;191;144;2033;156;0;11;167;52;25;C;153452
36092;0;150;4581;0;2995;387;314;1775;240;134;2149;165;3;29;197;52;25;C;108199
14855;0;0;1190;0;1701;0;0;1267;757;0;2024;163;5;0;168;52;29;C;45281
61252;0;0;8663;0;3835;0;0;1576;204;0;1780;143;7;0;150;52;27;J;4935
27165;0;0;2902;0;1991;0;0;1729;303;8;2040;159;9;0;168;52;24;C;63765
33932;0;0;4806;0;2421;0;0;2024;0;0;2024;160;8;0;168;52;32;M;54953
30863;1143;230;4490;0;2204;71;0;1588;253;29;1870;125;16;7;148;52;25;D;123358
36385;649;0;4870;0;2441;0;0;1813;172;0;1985;156;13;0;169;52;26;H;147694
25047;0;0;5796;0;1572;42;0;1736;308;12;2056;164;18;6;188;52;27;B;96948
128031;634;0;30831;0;7646;0;0;1788;236;0;2024;168;0;0;168;52;30;J;179244
29578;0;436;4905;0;1999;62;0;1710;294;26;2030;161;0;5;166;52;25;B;82566
8962;0;0;0;0;1137;0;0;1098;0;0;1098;172;0;0;172;0;0;S;143691
40898;0;0;5581;0;2716;112;0;1641;243;40;1924;127;37;6;170;52;26;K;34780
46413;0;0;1788;0;1946;38;53;1449;423;12;1884;117;39;3;159;52;64;Q;43570
15459;0;0;1431;0;1321;0;0;1257;630;0;1887;152;0;0;152;49;7;N;64130
24439;0;0;0;0;2155;0;181;1606;0;0;1606;162;0;0;162;52;30;Q;33806
24381;0;0;1375;0;2059;0;0;1877;227;253;2357;168;0;0;168;52;3;C;113183
26834;0;0;3707;0;1898;28;0;1851;248;15;2114;166;7;2;175;52;23;H;4555
29160;0;0;0;0;2614;147;0;1688;528;112;2328;160;16;10;186;52;22;F;107397
27316;0;0;4379;0;1873;23;0;1569;389;136;2094;155;3;8;166;52;22;M;100287
35276;0;0;5193;0;2513;0;0;1755;226;0;1981;156;8;0;164;52;29;H;50500
28838;0;1255;3641;0;2131;216;0;1742;274;132;2148;165;3;17;185;52;23;J;87397
23995;0;0;2;0;1744;0;0;1561;257;0;1818;111;88;0;199;52;15;G;178562
45870;0;5113;0;0;3771;0;0;1872;180;0;2052;132;24;0;156;0;30;J;42814
41082;0;1000;2788;0;2788;0;0;1755;284;5;2044;168;0;0;168;52;28;C;162041
29775;0;723;1695;0;2514;298;356;1800;0;175;1975;168;10;21;199;52;218;C;113950
32760;0;0;2754;0;2737;86;0;1657;233;2;1892;155;0;6;161;52;29;K;91362
33651;0;0;2296;0;3286;0;0;1761;168;0;1929;159;0;0;159;52;21;Q;154532
13660;0;0;2732;0;1366;0;0;1648;32;0;1680;136;32;0;168;44;4;J;182101
42000;0;0;12000;0;3000;150;0;1920;0;12;1932;160;0;1;161;52;25;C;104966
10349;0;0;1092;0;1993;0;0;775;112;0;887;168;0;0;168;25;0;F;138517
24252;0;0;4097;0;2326;0;0;1560;24;14;1598;132;6;0;138;52;41;Q;155776
32816;0;23088;6113;0;2128;195;0;1716;252;167;2135;156;7;12;175;52;20;J;55834
29120;0;0;2190;0;2240;50;0;1673;367;30;2070;149;19;3;171;52;26;H;22056
38612;0;0;4118;0;2647;0;2245;1644;228;5;1877;156;0;0;156;52;34;E;54184
4454;0;360;0;0;953;70;0;598;0;39;637;144;8;9;161;0;20;S;180830
22887;0;0;3184;0;1592;0;0;1850;0;0;1850;167;0;0;167;52;26;R;168306
13931;0;0;1271;0;1139;0;80;956;1132;0;2088;104;64;0;168;52;18;C;515
35210;0;32991;2219;0;2575;0;163;1735;137;0;1872;146;9;0;155;52;19;Q;111622
37259;0;0;2484;0;2553;141;0;1872;161;211;2244;168;0;21;189;52;19;C;117731
23481;0;0;3489;0;1547;180;0;1733;355;93;2181;160;8;15;183;52;28;C;133169
22227;0;0;2898;0;2279;0;79;1737;327;0;2064;101;58;0;159;52;15;I;2431
23969;0;21291;2678;0;1881;308;4;1939;175;305;2419;182;0;32;214;52;24;N;161881
5342;0;0;469;0;1547;141;0;560;104;52;716;160;8;14;182;12;8;C;179941
56305;0;0;11280;0;3311;0;0;1481;541;0;2022;168;0;0;168;52;34;H;154091
25729;0;0;3575;0;1806;0;205;1617;418;0;2035;121;47;0;168;52;25;C;26377
NA;0;0;0;0;1987;0;0;NA;NA;NA;NA;173;0;0;173;52;25;C;96353
28781;0;0;5115;0;1970;117;0;1854;126;136;2116;145;20;9;174;52;20;M;148954
23221;0;0;1544;0;1797;0;101;1527;326;9;1862;126;36;3;165;52;41;Q;125062
113383;0;0;26422;0;7122;0;0;1744;332;0;2076;168;0;0;168;52;37;C;79693
19;0;0;1;0;NA;0;0;1653;253;77;1983;160;0;1;161;52;31;F;99121
12258;0;0;65;0;840;0;0;0;1976;0;1976;0;168;0;168;52;0;C;173421
16911;0;0;1245;0;1228;0;0;1864;272;0;2136;168;0;0;168;52;22;C;59343
39254;0;0;7050;0;2286;0;0;1639;0;100;1739;157;0;31;188;52;32;K;62379
18697;0;0;2155;0;1359;0;0;1904;116;0;2020;168;0;0;168;50;1;C;54933
21666;0;0;2183;0;1578;0;0;1831;320;21;2172;160;8;7;175;52;25;H;34781
33688;975;29516;3197;0;2459;0;0;1760;328;8;2096;159;9;0;168;52;24;C;70900
64484;825;0;10778;0;4391;0;0;1607;417;0;2024;160;8;0;168;52;49;C;105758
158499;2802;0;26258;0;10658;0;0;1840;200;0;2040;168;0;0;168;52;25;C;141777
24507;0;0;1581;0;1908;314;0;1838;218;299;2355;195;0;27;222;52;194;C;113774
60345;0;0;6925;0;3818;0;0;1817;203;0;2020;163;0;0;163;52;22;G;45403
29272;0;0;2333;0;2012;0;0;1428;428;28;1884;145;15;0;160;46;30;C;130870
21824;0;0;3056;0;1679;177;0;1607;406;16;2029;168;0;16;184;52;39;C;83634
29218;0;25227;3983;0;2120;0;0;1189;899;60;2148;137;14;5;156;52;37;Q;154578
46170;0;3451;8197;0;3340;0;0;1617;210;180;2007;150;0;0;150;52;28;S;184325
26709;0;620;4970;0;1808;0;0;1732;277;0;2009;161;1;0;162;52;31;G;9470
25526;0;0;4751;0;1683;0;0;1812;245;33;2090;111;40;0;151;52;18;C;27224
46143;0;0;11263;0;5905;0;0;1824;296;0;2120;168;0;0;168;52;16;M;91062
19132;0;0;13;0;1508;292;0;1883;147;371;2401;166;0;35;201;52;17;B;23019
37148;0;0;5628;0;2229;0;0;1371;302;0;1673;140;4;0;144;52;33;C;102687
2770;0;0;352;0;NA;0;0;239;0;0;239;NA;NA;0;NA;7;0;C;30825
53661;0;0;4464;0;3828;0;0;1573;168;114;1855;152;0;0;152;52;20;D;59038
31558;0;26729;4829;0;2375;146;252;1658;219;115;1992;136;16;8;160;52;29;E;132676
46609;0;0;5854;0;3456;0;0;1318;339;0;1657;120;0;0;120;52;27;K;59392
22800;0;0;2300;0;1753;184;0;1672;390;105;2167;146;8;13;167;52;42;C;81831
19878;0;0;2851;0;1444;0;12;1608;401;0;2009;168;0;0;168;52;18;I;162611
29611;0;0;2554;0;2209;0;0;1778;310;0;2088;168;0;0;168;52;32;C;37939
14047;0;0;1;0;867;0;0;640;0;0;640;160;0;0;160;4;30;F;35413
25405;21003;0;3502;0;1860;14;44;1753;306;35;2094;163;12;1;176;52;27;G;170224
36870;0;33848;3022;0;2816;0;0;1578;245;0;1823;129;7;0;136;52;33;Q;75355
NA;0;0;1055;0;1092;92;0;1822;172;205;2199;165;0;4;169;52;22;H;126670
30157;0;0;2328;0;2237;0;446;1526;302;32;1860;136;22;0;158;52;27;Q;112183
31052;0;568;2347;0;2190;0;0;1502;370;0;1872;156;0;0;156;52;29;R;25124
16837;0;0;1612;0;1511;0;0;1366;108;40;1514;1366;108;40;NA;48;9;N;41399
74550;0;5667;0;0;5667;0;0;1793;295;0;2088;168;0;0;168;52;30;C;46680
11769;0;0;952;0;1051;0;0;1130;347;87;1564;100;0;0;100;51;19;Q;146532
27346;0;0;4633;0;2092;6;391;1469;512;20;2001;158;18;3;179;52;44;C;134952
6601;0;0;595;0;1043;0;0;621;124;0;745;127;0;0;127;23;10;C;59415
24059;0;0;2638;0;2187;151;0;1598;202;152;1952;145;18;13;176;48;25;C;3771
38386;0;0;2674;0;3592;1050;0;1682;406;564;2652;168;0;66;234;52;25;E;44807
25215;0;0;3404;0;1810;104;0;1556;342;68;1966;156;0;7;163;52;27;E;9439
40252;0;0;4390;0;3203;417;111;1588;398;128;2114;150;18;0;168;52;34;C;91568
30004;0;0;2122;0;2074;0;0;1643;407;22;2072;136;32;0;168;52;20;C;27175
44418;0;0;2222;0;2626;323;0;1492;552;177;2221;147;45;34;226;52;31;Q;32163
15233;0;0;1955;0;1466;0;174;1705;101;0;1806;160;0;0;160;52;15;S;170939
37043;0;0;1914;0;3321;0;0;1564;322;0;1886;131;21;0;152;52;36;Q;99079
29772;0;0;1767;0;1767;0;0;1338;454;244;2036;112;36;19;167;52;16;M;186016
39894;0;0;2771;0;2771;0;0;1872;248;0;2120;168;0;0;168;52;20;J;8468
46591;0;0;7765;0;NA;0;0;1686;0;0;1686;NA;NA;0;NA;52;32;G;78163
59398;0;0;5925;0;3753;0;0;1711;265;0;1976;165;0;0;165;52;23;C;62813
18807;0;0;1366;0;1544;0;0;1775;120;121;2016;149;7;7;163;52;16;C;153449
38925;1060;27114;8354;0;2430;163;0;1647;320;105;2072;146;15;8;169;52;20;G;43783
32600;770;0;4100;0;3400;15;0;1500;480;16;1996;147;8;0;155;52;32;C;175328
23331;0;0;4056;0;1666;20;0;1662;182;43;1887;169;0;2;171;52;26;G;121702
39651;0;0;2886;0;2912;0;0;1855;258;0;2113;160;8;0;168;52;32;C;31457
79186;1700;50875;8731;0;5121;350;356;1646;234;153;2033;143;13;7;163;52;28;H;920
34625;0;0;3328;0;2229;0;0;1768;248;0;2016;168;0;0;168;52;25;H;97803
23634;0;0;1796;0;1744;0;0;1872;168;15;2055;168;0;0;168;52;21;C;10463
14644;0;0;1475;0;1475;0;159;1008;264;0;1272;160;8;0;168;26;33;C;120943
29322;0;0;2225;0;2691;467;0;1574;325;197;2096;157;11;27;195;52;20;C;157170
66319;0;0;6202;0;7443;0;0;1168;192;0;1360;120;48;0;168;35;21;M;66045
9683;0;0;677;0;1391;209;0;1180;0;105;1285;182;0;28;210;39;0;N;77583
18800;0;0;2;0;1573;0;0;1093;939;0;2032;0;168;0;168;52;17;C;6944
17054;0;0;1514;0;1514;0;0;1765;223;38;2026;128;40;0;168;52;25;C;130549
28173;0;0;3944;0;1978;0;0;1975;230;0;2205;155;4;0;159;52;27;K;90379
5945;0;0;457;0;1829;0;0;480;0;0;480;159;0;0;159;13;4;N;2972
41106;0;23937;6270;0;2932;931;0;1630;343;605;2578;132;31;57;220;52;25;J;55835
18430;0;0;2839;0;1531;18;0;1838;155;42;2035;160;8;1;169;51;17;C;25671
5774;0;410;0;0;1225;0;0;652;0;0;652;160;8;0;168;0;0;C;139618
35106;0;29110;5996;0;2930;0;0;1445;592;0;2037;128;16;0;144;52;33;C;22972
31199;0;0;1841;0;2255;0;0;1682;120;0;1802;157;12;0;169;52;14;Q;51363
65820;0;0;7980;0;5004;0;0;1640;268;0;1908;135;23;0;158;52;24;K;59303
29053;0;3947;4295;0;2520;0;0;1576;499;13;2088;128;56;0;184;52;21;C;42669
44434;1227;35339;7868;0;2421;0;0;1679;251;0;1930;154;4;0;158;52;27;G;123977
29616;1421;0;1978;0;2391;0;0;1732;412;0;2144;110;58;0;168;52;42;J;141584
27723;0;0;3663;0;1978;144;0;1701;242;100;2043;151;4;12;167;52;25;N;4619
2232;0;0;100;0;2232;0;0;160;0;0;160;160;0;0;160;4;0;J;168281
36596;0;1559;5242;0;2620;0;0;NA;NA;NA;NA;NA;NA;0;NA;52;0;K;156746
38332;1205;0;2202;0;3171;326;0;1856;184;232;2272;168;0;21;189;52;23;F;26096
20892;0;0;2771;0;1560;0;0;1666;370;0;2036;159;14;0;173;51;30;H;147087
52736;0;0;7378;0;3531;0;0;1463;101;116;1680;129;14;14;157;52;28;M;20244
28035;0;0;2827;0;2079;0;0;1755;247;0;2002;157;0;0;157;52;20;K;72953
45333;0;760;8400;0;3132;0;551;1354;554;4;1910;132;28;0;160;52;25;C;130656
35647;0;0;1960;0;5034;636;0;1453;640;209;2302;128;40;40;208;52;36;C;118682
36897;0;0;5000;0;2636;0;0;1710;200;26;1936;136;22;2;160;52;25;E;98838
20335;0;0;1832;0;1544;0;0;1592;230;12;1834;151;0;0;151;52;33;Q;114366
20159;1631;0;2667;0;1468;9;0;1845;221;13;2079;166;2;1;168;52;20;N;74895
15935;0;0;1;0;2031;510;303;1015;0;450;1465;119;0;62;181;52;0;C;28172
63876;0;0;1776;0;2853;0;0;1657;281;0;1938;160;0;0;160;52;37;M;85660
32177;0;0;1798;0;2824;80;0;1969;183;232;2384;192;3;38;233;52;23;C;68898
43414;0;0;7107;0;2954;117;0;1568;340;178;2086;155;3;15;173;52;23;K;133055
29490;0;0;2968;0;2190;175;0;1695;125;193;2013;147;3;15;165;52;17;E;72173
64047;0;0;9449;0;5135;0;0;1577;0;8;1585;127;0;0;127;52;28;K;71380
41977;0;0;5226;0;2639;0;0;1648;336;0;1984;152;8;0;160;52;23;I;123264
27238;0;0;3585;0;2117;0;0;1490;850;3;2343;153;42;0;195;52;28;H;110345
59231;0;51222;6094;0;5002;0;0;1618;278;27;1923;147;6;0;153;52;42;Q;153686
43527;0;0;5124;0;2872;473;0;1668;203;203;2074;155;0;20;175;52;24;K;17089
26024;0;0;3503;0;1881;0;0;1432;324;70;1826;128;14;3;145;52;30;Q;182015
21795;0;0;1828;0;2315;157;204;1772;8;81;1861;159;1;12;172;48;33;C;14700
28198;0;0;4821;0;1962;0;0;1483;197;66;1746;126;30;0;156;52;30;E;51961
39000;0;3828;774;0;2931;0;0;1730;158;0;1888;165;11;0;176;52;19;C;109474
27814;0;0;2300;0;2119;0;0;1294;748;0;2042;126;42;0;168;52;28;C;135226
32915;0;0;3738;0;3539;106;141;NA;NA;NA;NA;NA;NA;NA;NA;52;0;Q;93212
10258;0;0;1437;0;1490;0;0;1068;103;0;1171;163;14;0;177;31;18;H;20412
20240;0;0;495;0;1568;52;0;1302;186;40;1528;152;8;4;164;52;18;H;2711
19334;0;0;2325;0;1556;0;0;1760;327;0;2087;140;20;0;160;52;27;H;41807
22396;0;0;1;0;1694;0;0;1963;183;0;2146;186;0;0;186;52;14;S;23805
28862;0;0;4081;0;2056;0;0;1776;272;0;2048;168;0;0;168;52;29;G;38739
27963;0;0;5459;0;1875;0;0;1808;280;0;2088;151;17;0;168;52;20;C;57948
33631;0;0;4500;0;2495;120;12;1710;245;90;2045;162;7;9;178;52;27;H;92023
31233;0;0;4115;0;2057;0;0;1976;400;0;2376;168;0;0;168;52;34;G;64481
26709;0;0;4451;0;2225;0;0;1815;524;0;2339;169;25;0;194;52;39;H;96831
30377;0;0;6079;0;2579;0;0;1700;388;0;2088;168;0;0;168;52;18;J;69149
21861;0;0;1713;0;1852;56;638;1727;313;28;2068;168;0;4;172;52;6;C;113672
20150;0;0;2890;0;1455;0;0;1595;421;12;2028;142;26;0;168;52;29;G;83798
25554;0;22874;2680;0;3203;960;0;2104;96;631;2831;240;0;72;312;39;12;H;107269
108363;952;69168;37830;0;5445;0;0;1706;276;0;1982;120;38;0;158;52;24;D;42934
30960;0;0;4662;0;2180;0;100;1503;342;105;1950;173;0;17;190;52;29;Q;150195
19050;0;1200;1426;0;1462;0;0;1678;302;0;1980;165;0;0;165;52;27;S;162828
55884;0;0;3580;0;3580;0;0;1708;388;0;2096;160;8;0;168;52;36;C;60789
27770;0;984;3590;0;2258;282;101;1890;117;109;2116;159;13;9;181;52;17;H;47457
26403;0;0;1653;0;2209;72;0;1502;429;0;1931;160;6;6;172;52;28;Q;125899
21394;0;0;2917;0;1480;10;0;1800;240;10;2050;160;8;1;169;52;20;R;87020
21590;0;0;1105;0;1799;0;0;961;1115;0;2076;80;88;0;168;52;13;M;137486
38280;0;0;6380;0;3190;0;0;1735;0;0;1735;140;0;0;140;52;31;K;15286
47444;0;0;5979;0;4496;0;0;1888;216;0;2104;168;0;0;168;51;16;J;86396
48223;0;0;2638;0;4009;1380;0;1694;337;765;2796;162;6;75;243;52;42;C;149823
40803;0;0;8544;0;2542;0;0;1770;172;0;1942;156;0;0;156;52;17;H;61383
25978;0;0;2498;0;2036;54;0;1387;392;52;1831;107;61;3;171;52;40;C;120867
22903;0;0;1609;0;1650;168;0;1734;252;145;2131;128;0;14;142;52;252;C;130217
22883;1063;0;3083;0;1562;0;0;1672;384;4;2060;136;8;0;144;52;31;G;178707
19175;0;0;1475;0;1475;0;0;1760;160;0;1920;160;0;0;160;52;20;C;174120
32272;0;0;2086;0;2464;0;0;1872;0;11;1883;156;7;0;163;52;26;R;40638
16164;0;0;2350;0;1347;90;0;1583;410;33;2026;159;0;11;170;52;11;E;157732
24560;0;0;5275;0;2250;385;0;1611;312;149;2072;159;9;26;194;52;30;D;82510
20888;0;0;1519;0;1678;159;0;1715;2207;72;3994;159;183;15;357;52;23;C;58465
35099;0;909;2804;0;2966;0;0;1683;358;0;2041;154;14;0;168;52;44;C;149305
30144;0;0;2706;0;2450;170;0;1532;546;11;2089;147;36;11;194;52;32;Q;145901
43423;0;0;2380;0;3921;0;0;1645;238;35;1918;157;4;9;170;52;30;R;185503
1450;0;0;1450;0;1450;0;0;1760;0;0;1760;160;0;0;160;4;20;C;98725
18693;0;0;1416;0;1416;0;0;1805;275;0;2080;117;56;0;173;52;20;C;88686
50617;0;1425;7116;0;3632;0;0;1676;348;0;2024;156;12;0;168;52;17;C;17229
145943;0;80197;5860;0;8634;0;18;1567;394;13;1974;132;21;20;173;52;35;Q;148912
16983;0;0;2406;0;1226;0;172;1611;315;0;1926;162;6;0;168;52;28;Q;129571
15410;0;0;1285;0;1541;0;0;1726;414;0;2140;124;38;0;162;44;13;S;73353
36410;0;0;2012;0;2012;0;0;1437;0;0;1437;160;0;0;160;52;31;C;179477
28659;0;0;2627;0;2837;0;0;1619;457;29;2105;158;10;0;168;52;49;N;111950
31687;209;540;5336;0;2171;0;0;1524;285;46;1855;136;14;6;156;52;39;Q;31629
20844;0;0;3047;0;1737;0;274;1420;501;61;1982;140;23;0;163;52;15;C;99306
39050;0;0;5822;0;2571;0;0;1728;297;0;2025;159;9;0;168;52;37;N;29768
25905;0;0;4379;0;1683;0;0;1737;184;21;1942;162;0;0;162;52;25;G;130091
29597;200;0;2073;0;2323;90;0;1836;204;104;2144;160;8;14;182;52;17;J;49833
34683;0;0;2162;0;2679;0;0;1242;528;41;1811;124;18;8;150;52;27;Q;32250
12185;0;0;835;0;2840;0;0;1097;5;0;1102;255;1;0;256;31;14;C;59473
31720;0;0;5058;0;3065;0;0;1758;257;0;2015;162;2;0;164;52;27;C;110426
20900;0;0;3500;0;1742;11;0;1809;181;28;2018;163;0;1;164;52;19;C;74576
402175;0;250000;11668;0;11538;0;0;1554;0;0;1554;163;0;0;163;52;21;K;45027
73999;0;7497;6390;0;5293;393;0;1562;332;168;2062;128;16;15;159;52;10;E;113648
47070;0;0;6347;0;3654;0;0;1595;330;0;1925;157;0;0;157;52;26;K;100696
24528;21110;0;3418;0;1938;0;42;1852;264;13;2129;124;43;0;167;52;33;G;178139
28099;0;0;4132;0;2065;0;0;1826;329;0;2155;155;0;0;155;52;22;M;163665
18730;0;0;1294;0;1335;40;0;1792;231;159;2182;146;22;5;173;52;29;N;55376
16069;0;0;2762;0;1386;0;0;1296;620;0;1916;119;49;0;168;52;28;K;22309
30175;0;0;4082;0;2101;0;49;1703;285;13;2001;128;22;0;150;52;32;G;60851
22811;0;0;191;0;1289;0;0;1709;215;433;2357;164;0;0;164;52;21;S;56674
22354;0;0;3170;0;1595;0;0;1829;267;0;2096;168;0;0;168;52;22;M;152986
32753;0;27842;4911;0;2423;354;0;1797;236;153;2186;167;1;20;188;52;28;C;37203
51684;0;0;8614;0;4307;0;0;1666;366;0;2032;148;20;0;168;52;25;C;172758
24709;0;0;3362;0;1738;0;0;1632;210;0;1842;156;0;0;156;52;35;E;81215
22172;0;0;0;0;2984;0;0;1900;140;0;2040;168;0;0;168;52;17;C;11368
44198;0;0;1400;0;3424;0;0;1717;172;0;1889;157;0;0;157;52;23;K;148672
26375;0;0;1410;0;2044;301;158;1686;267;314;2267;160;0;24;184;52;16;C;51787
21559;0;0;2381;0;1595;0;0;1662;370;0;2032;142;26;0;168;52;20;J;69984
28871;0;0;2;0;1639;0;0;1682;173;0;1855;168;0;0;168;52;0;C;109151
31391;0;0;3444;0;2405;253;0;1928;110;250;2288;172;0;24;196;52;16;Q;170417
25685;0;0;3531;0;2296;0;0;1580;0;237;1817;142;0;19;161;52;26;K;87305
21229;0;0;3180;0;1591;0;0;1640;400;0;2040;140;28;0;168;52;25;M;115013
48706;0;0;6958;0;3479;0;0;1808;280;0;2088;160;8;0;168;52;23;M;16754
20630;0;0;7336;1360;7686;0;0;1033;33;0;1066;173;0;0;173;27;0;I;32761
22980;0;0;3358;0;1578;53;0;1664;352;76;2092;127;41;4;172;52;37;G;172506
21061;0;0;1894;0;1594;0;0;1729;279;0;2008;168;0;0;168;52;23;C;139754
26919;0;0;2029;0;21985;348;0;1744;284;52;2080;1434;246;25;NA;4;19;C;159460
24404;0;0;3237;0;1636;0;0;1841;175;70;2086;156;12;8;176;52;4;N;18982
98831;0;0;14495;0;7085;0;0;1872;204;0;2076;168;0;0;168;52;25;C;147725
10543;0;0;847;0;2033;0;0;733;67;0;800;168;0;0;168;20;9;M;139887
22024;0;0;3134;0;1567;0;0;1662;193;0;1855;148;5;0;153;52;2;K;102458
41716;0;0;5172;0;3810;253;92;1495;214;66;1775;164;7;5;176;52;30;H;30955
16776;0;0;1453;0;1504;0;0;1328;0;704;2032;168;0;0;168;52;15;C;151188
31403;0;0;1409;0;2713;262;205;1965;130;177;2272;168;0;19;187;52;14;C;109765
47123;78;0;7848;0;3087;0;0;1658;348;14;2020;133;31;0;164;52;24;G;119499
24331;0;0;1903;0;1876;16;0;1862;58;0;1920;160;0;0;160;52;0;C;172910
59974;4067;0;10930;0;3979;0;0;1750;354;0;2104;160;8;0;168;52;39;M;173237
43061;0;0;1;0;3408;0;0;1853;0;183;2036;162;0;17;179;52;13;F;18658
23211;363;1761;2141;0;1769;0;0;1591;281;0;1872;141;9;2;152;52;25;M;134092
26427;0;0;1780;0;1875;13;0;1768;248;45;2061;128;40;1;169;52;26;H;54304
31721;0;0;4246;0;2259;0;0;1669;419;6;2094;156;12;0;168;52;31;C;172091
22800;0;0;1760;0;1755;0;0;1393;639;10;2042;8;160;0;168;52;33;C;135971
21232;0;0;2825;0;1659;0;0;1694;317;0;2011;146;13;0;159;52;33;Q;162501
28818;0;1127;3353;0;2390;535;54;1584;429;333;2346;155;18;38;211;52;30;C;84671
14640;370;0;1047;0;1916;78;26;1076;238;108;1422;152;10;9;171;38;8;C;92343
70495;0;0;6528;0;5329;0;0;1714;243;7;1964;155;0;0;155;52;17;C;180762
22646;42;0;2336;0;1765;130;0;1777;255;29;2061;160;8;11;179;52;32;S;85398
23385;98;0;3134;0;1567;0;0;1597;213;64;1874;148;4;0;152;52;29;K;88675
55359;0;0;16340;0;4456;0;0;1548;492;0;2040;128;40;0;168;52;23;C;165573
23286;0;0;2238;0;1938;0;0;1746;256;0;2002;155;13;0;168;52;29;C;123488
27040;0;3063;2097;0;2046;0;0;1582;228;12;1822;125;0;30;155;52;36;Q;185542
25298;0;0;7444;0;2117;0;0;1856;322;0;2178;168;0;0;168;52;32;J;69151
24790;0;0;1589;0;1589;102;0;1799;0;42;1841;168;0;5;173;52;18;C;98966
14198;0;0;992;0;1183;0;0;1398;131;0;1529;160;8;0;168;48;13;C;57020
17954;0;0;2604;0;1605;0;125;1326;441;28;1795;140;16;0;156;48;18;C;109420
34548;0;0;3455;0;1913;0;0;1744;184;0;1928;104;64;0;168;52;184;F;109592
19319;0;0;2387;0;1883;100;134;1183;145;32;1360;154;19;0;173;27;8;C;48192
79958;0;74450;5508;0;6066;0;557;1767;158;90;2015;158;0;0;158;52;17;Q;84509
36748;0;0;4944;0;2780;0;0;1976;179;30;2185;169;8;0;177;48;21;D;65174
30541;0;0;1900;0;2423;576;65;2502;267;250;3019;166;0;52;218;52;26;C;86527
41188;0;0;6522;0;2887;0;0;1500;394;0;1894;117;40;0;157;52;24;J;21082
60974;0;0;5557;0;3700;120;0;1644;204;145;1993;152;0;27;179;52;26;C;36844
50754;0;0;8422;0;3290;0;0;1427;319;0;1746;155;16;0;171;52;21;C;76368
12485;0;0;1;0;1139;0;0;2280;0;0;2280;168;0;0;168;36;0;M;23635
13018;0;0;1157;0;1306;0;0;908;984;0;1892;136;6;0;142;52;28;C;148496
21021;0;0;1752;0;1912;0;0;1717;0;0;1717;173;0;0;173;48;15;J;161255
23781;0;0;1830;0;1830;0;0;1765;267;1;2033;152;16;0;168;52;20;C;98218
10544;0;0;821;0;1738;72;0;1013;242;18;1273;121;38;6;165;32;9;D;184036
12281;0;0;146;0;1118;0;0;1345;108;0;1453;167;6;0;173;40;8;E;112510
28819;24860;0;3959;0;2200;97;46;1829;215;41;2085;168;7;7;182;52;24;G;170157
33411;0;0;9020;0;2621;0;0;1751;281;0;2032;137;32;0;169;52;35;C;182302
48477;0;0;1915;0;3436;107;0;1557;264;83;1904;121;29;7;157;51;25;M;184587
15600;0;0;26;0;1301;85;0;1568;299;485;2352;173;21;10;204;52;290;N;4673
27400;0;0;0;0;2006;0;0;1775;265;158;2198;120;48;11;179;52;33;C;35911
25494;0;0;3880;0;2033;0;0;1398;582;0;1980;172;0;0;172;52;19;H;160328
34127;0;0;3440;0;2938;420;784;1421;408;88;1917;103;1;24;128;52;19;C;40547
39123;0;0;7109;0;2595;6;0;1634;0;222;1856;138;0;0;138;52;34;H;108951
22800;0;0;3344;0;1431;0;0;1688;413;12;2113;150;18;0;168;52;25;C;33003
6053;0;0;838;0;1296;0;0;555;117;4;676;124;44;0;168;17;8;R;87006
21543;0;0;1452;0;1394;0;0;1628;288;0;1916;141;8;0;149;52;25;S;53056
19961;0;0;4332;0;1564;0;0;1672;251;96;2019;162;6;0;168;52;28;D;82489
17733;0;0;1478;0;1478;65;0;1690;350;10;2050;168;0;6;174;52;164;C;161708
36000;0;0;1;0;3000;0;0;NA;NA;NA;NA;NA;NA;0;NA;52;0;Q;144812
76258;0;0;9710;0;5564;0;0;1670;242;0;1912;165;0;0;165;52;27;K;65691
20347;0;17471;2876;0;1448;0;0;1735;305;0;2040;152;16;0;168;52;30;M;72946
14534;0;124;1009;0;1657;114;0;1260;106;115;1481;172;0;10;182;26;11;C;147870
38979;0;0;3513;0;3513;0;0;1665;0;0;1665;128;0;0;128;52;25;C;106827
29563;0;27406;2006;0;4228;0;353;1449;300;0;1749;126;0;0;126;52;35;Q;153
85542;0;0;7460;0;7460;0;0;1292;288;0;1580;171;0;0;171;52;32;Q;75859
35777;0;0;5043;0;2538;0;0;1679;409;5;2093;158;10;0;168;52;26;G;127842
18177;0;0;3097;0;1548;0;0;1067;266;0;1333;177;0;0;177;47;38;I;59248
25261;0;165;1965;0;2534;0;0;1617;176;45;1838;168;0;0;168;52;15;F;73499
26300;0;0;3500;0;1900;0;0;1653;380;0;2033;139;29;0;168;52;25;C;62308
46752;0;0;6451;0;3319;57;0;1756;228;36;2020;176;0;3;179;52;12;J;9631
13584;0;0;538;0;2667;0;0;437;2;0;439;120;0;0;120;0;0;F;97111
28857;27;0;6476;0;2199;382;30;1662;362;149;2173;136;32;23;191;52;26;C;145201
NA;0;0;0;0;2852;0;0;NA;NA;NA;NA;168;8;0;176;0;0;J;183194
40002;0;0;5464;0;2761;0;0;1527;350;0;1877;151;8;0;159;52;34;K;69729
22758;924;0;3530;0;1559;0;0;1627;215;127;1969;135;21;5;161;52;19;K;3539
20224;0;0;0;0;1794;62;0;1502;184;99;1785;148;8;5;161;52;21;F;2163
31389;0;0;2250;0;2371;0;0;1409;549;0;1958;116;42;0;158;52;50;Q;25496
25630;0;0;2788;0;1934;0;408;1621;455;21;2097;164;8;0;172;52;31;C;107552
36957;0;0;6127;0;2214;0;0;1700;334;395;2429;170;5;0;175;52;30;C;81878
23113;0;1682;0;0;1903;223;0;1752;280;194;2226;160;8;20;188;52;13;C;79882
37377;0;22821;4747;0;2629;323;20;1709;214;251;2174;123;45;26;194;52;33;H;97880
28809;0;0;4016;0;2008;0;0;1709;298;26;2033;159;5;0;164;52;30;M;169872
23282;0;0;1645;0;1645;0;0;1724;356;0;2080;127;40;0;167;52;26;R;174409
50211;0;0;6930;0;3504;24;0;1778;344;55;2177;156;12;1;169;52;32;G;112207
25761;0;1330;2746;0;2023;0;284;1443;334;17;1794;135;19;0;154;52;32;R;484
27387;0;0;3836;0;1949;0;0;129;317;NA;NA;112;60;0;172;52;44;I;167441
23052;0;0;4770;0;1791;0;0;1446;580;4;2030;125;39;0;164;52;20;C;107826
67250;0;62139;5111;0;5186;0;0;2070;228;0;2298;179;0;0;179;52;20;Q;101608
21408;0;0;2687;0;1577;277;0;1866;259;195;2320;175;0;30;205;52;15;N;184404
25971;0;0;1107;0;2414;506;0;1723;179;319;2221;164;0;45;209;52;22;H;41482
9951;0;0;684;0;841;0;0;1236;0;468;1704;1236;NA;468;NA;40;9;N;41410
18370;0;0;838;0;2082;0;99;818;353;44;1215;103;55;1;159;52;10;C;56421
34623;0;0;5392;0;2395;0;0;1720;448;0;2168;128;32;0;160;52;42;I;82013
41034;0;0;3387;0;3387;0;0;1844;243;0;2087;144;24;0;168;52;20;C;156344
35898;0;0;5408;0;2733;338;0;1774;296;171;2241;168;0;22;190;52;19;C;124643
34300;0;0;3212;0;2375;183;0;1705;0;244;1949;120;0;15;135;52;34;I;106572
26283;72;0;2353;0;2118;0;0;1602;410;7;2019;160;8;0;168;52;33;C;149699
28465;0;0;3575;0;2089;331;0;1753;287;237;2277;163;5;23;191;52;36;C;172305
25707;0;0;1855;0;2384;202;0;1890;246;156;2292;168;0;16;184;52;7;F;142366
25494;0;0;2888;0;1818;0;0;2036;260;0;2296;184;4;0;188;52;27;M;114763
41599;0;0;8346;0;2734;19;0;1585;206;37;1828;162;2;8;172;52;20;H;53978
23056;0;0;3127;0;1563;0;0;1745;296;62;2103;168;0;0;168;52;16;S;4824
39980;0;0;3581;0;3175;97;71;1903;385;233;2521;185;3;20;208;52;25;C;141794
29667;0;0;2366;0;2257;0;0;1495;529;0;2024;123;37;0;160;52;43;B;161036
38355;0;0;8082;0;4635;0;0;1725;211;0;1936;139;31;0;170;52;20;E;65283
18845;0;0;1449;0;1449;0;0;1845;135;0;1980;165;0;0;165;52;21;Q;164455
17800;0;0;1;0;1520;0;0;1900;160;0;2060;168;0;0;168;50;20;C;116726
25407;0;103;1410;0;2424;286;1276;1566;114;181;1861;168;0;23;191;42;12;C;74513
1410;0;0;13;0;1410;0;0;NA;NA;NA;NA;NA;NA;0;NA;4;15;C;82762
44641;0;0;2247;0;2974;0;0;1679;176;0;1855;149;0;0;149;52;22;H;1039
39225;0;0;1;0;3017;0;0;1556;349;181;2086;148;9;17;174;52;33;L;68816
33013;0;0;3234;0;2765;0;0;1762;262;3;2027;162;6;0;168;52;31;C;175541
20304;0;0;2888;0;1454;0;0;1772;268;0;2040;158;10;0;168;52;22;M;109326
29977;0;0;1737;0;2906;1118;23;2010;405;302;2717;245;0;77;322;52;38;C;10192
32381;0;0;2488;0;2469;181;0;1508;394;80;1982;156;2;13;171;52;25;K;180940
41829;0;0;3820;0;3145;0;0;1896;144;0;2040;168;0;0;168;48;18;F;13201
23004;1736;378;2857;0;1649;0;0;1629;352;0;1981;146;12;0;158;52;22;H;136301
4852;0;0;725;0;NA;0;0;446;0;0;446;NA;NA;0;NA;10;0;I;19557
37171;0;0;5675;0;2737;123;705;1670;276;26;1972;164;4;8;176;52;29;C;83756
60697;0;3441;8090;0;4045;0;0;1721;190;5;1916;167;0;0;167;52;20;C;121835
20113;0;0;1656;0;1515;0;0;1680;245;57;1982;153;22;0;175;52;34;C;49848
31956;0;0;4408;0;2491;0;0;1728;307;0;2035;159;5;0;164;52;31;G;112703
22762;0;0;1399;0;2096;163;129;1893;0;0;1893;183;0;15;198;48;20;C;154542
31944;0;0;5280;0;2228;0;191;1516;269;197;1982;126;28;7;161;44;32;R;25410
48087;0;0;3699;0;7894;0;0;1760;232;0;1992;104;72;0;176;52;18;M;147915
38287;0;0;4862;0;3957;0;224;NA;NA;NA;NA;NA;NA;0;NA;52;0;Q;93214
40276;0;0;6724;0;3379;0;0;1769;250;0;2019;174;2;0;176;52;21;M;81804
17282;50;0;5555;0;2232;27;550;1699;286;21;2006;144;8;3;155;52;23;C;115526
46358;0;0;4816;0;5226;1731;0;1562;424;707;2693;160;8;131;299;52;21;C;166447
6596;0;0;434;0;1847;151;0;472;104;47;623;123;45;12;180;13;5;C;15427
108546;0;25000;8100;0;6257;0;0;1718;322;0;2040;168;0;0;168;52;35;C;82010
31999;0;0;4597;0;2299;0;0;1703;295;0;1998;157;11;0;168;52;21;N;124457
10455;0;0;804;0;931;0;0;919;0;0;919;100;0;0;100;52;20;G;126130
64018;0;7561;17761;0;3557;207;0;1769;312;3;2084;168;0;8;176;52;21;G;119591
24813;0;0;500;0;1863;0;0;1685;123;0;1808;173;45;0;218;52;19;C;105682
27328;0;0;3710;0;2055;0;0;1829;203;0;2032;176;0;0;176;52;25;M;166059
30765;0;0;2558;0;2564;0;0;1431;176;4;1611;128;2;0;130;52;13;L;15232
19121;0;0;2736;0;1375;0;0;1800;232;0;2032;128;40;0;168;52;29;N;50801
24889;0;12;3168;0;1776;0;65;1753;335;96;2184;130;38;5;173;52;28;G;142108
44832;0;0;2079;0;3758;0;0;1933;154;0;2087;168;0;0;168;52;10;E;118246
73035;0;0;2954;60000;NA;0;0;413;383;0;796;NA;NA;0;NA;31;8;C;184189
37234;0;0;6410;0;2545;876;0;2013;0;204;2217;165;0;18;183;4;25;Q;62234
29041;0;0;2747;0;2631;0;0;1536;552;0;2088;168;0;0;168;47;22;F;35693
18234;0;0;2604;0;1121;0;0;1491;418;0;1909;113;16;0;129;52;20;G;58277
38599;0;0;6376;0;2459;0;0;1548;342;0;1890;126;0;0;126;52;19;J;54591
29458;0;2715;470;0;2337;0;788;1641;439;8;2088;161;7;0;168;52;33;C;80625
23993;0;1200;2685;0;1450;305;0;1684;348;380;2412;120;48;32;200;52;16;N;124450
22101;0;0;1727;0;1750;0;0;1856;220;0;2076;140;20;0;160;52;28;C;107244
18771;0;0;4836;0;1564;0;0;1715;159;0;1874;159;5;0;164;52;27;H;90226
27417;0;0;2762;0;2078;180;0;1696;328;86;2110;168;0;11;179;52;28;C;78403
43056;0;0;3262;0;3262;0;0;1766;332;0;2098;152;16;0;168;52;21;C;70532
27963;0;0;2927;0;2285;255;0;1360;464;47;1871;133;27;11;171;46;31;C;130958
34257;0;0;4374;0;2387;165;0;1650;383;124;2157;145;15;10;170;52;32;C;166020
24455;0;0;1646;0;1911;7;135;1624;635;9;2268;112;77;1;190;52;21;C;124168
25914;0;0;2392;0;NA;0;86;1519;252;0;1771;120;18;0;138;52;41;Q;135854
45567;0;0;4671;0;4889;40;0;1683;267;30;1980;127;30;0;157;52;32;K;157957
10035;0;0;713;0;1043;0;0;1223;43;29;1295;150;18;0;168;52;5;C;149481
26202;0;0;2276;0;1755;128;0;1916;116;114;2146;168;0;11;179;52;14;C;137669
27751;0;0;3481;0;2050;0;0;1872;0;0;1872;156;0;0;156;52;30;H;24811
52;19285;0;7669;0;1595;0;0;1709;176;0;1885;168;0;0;168;0;19;J;43520
25395;0;0;1814;0;1814;62;0;1960;66;8;2034;168;40;4;212;52;11;C;46761
19826;0;4200;2935;0;1468;0;0;1808;272;0;2080;137;31;3;171;52;35;Q;24486
23837;0;0;1484;0;1681;0;94;1768;264;4;2036;156;12;0;168;52;33;F;77297
23467;0;0;3310;0;1602;0;0;1711;725;0;2436;146;57;0;203;52;29;M;121285
31370;0;28383;2986;0;2372;0;0;1410;437;0;1847;157;3;0;160;52;25;K;22139
108159;0;0;12036;0;20345;0;0;1857;232;0;2089;168;0;0;168;52;22;J;87363
59388;0;0;13605;0;3758;0;0;1503;388;0;1891;118;40;0;158;52;30;K;114203
9700;0;0;1133;0;1363;0;28;1024;0;0;1024;172;0;0;172;30;0;I;30613
46301;136;0;9598;0;2816;0;0;1699;333;0;2032;158;10;0;168;52;24;J;121022
27548;0;0;2626;0;1825;0;0;1550;577;179;2306;160;8;0;168;52;8;C;110189
19138;0;0;2734;0;1367;0;0;NA;NA;NA;NA;NA;NA;0;NA;52;19;N;41328
42361;0;0;2777;0;3931;955;0;1437;353;142;1932;111;36;19;166;52;46;Q;95396
27132;0;0;3876;0;1938;0;0;1438;336;12;1786;108;24;0;132;52;24;G;86362
21479;0;0;2948;0;1639;0;0;1629;387;76;2092;173;0;12;185;52;26;G;101083
57321;0;40649;16672;0;3387;0;0;1692;300;0;1992;168;0;0;168;52;27;C;40011
17797;0;0;2669;0;1388;0;0;1493;379;35;1907;137;40;0;177;52;33;G;136691
17983;0;0;1;0;1368;0;0;1744;216;0;1960;168;0;0;168;52;20;J;151585
19176;0;1318;1;0;1643;62;0;1651;207;59;1917;155;13;5;173;52;22;C;172687
7795;0;0;534;0;1268;0;0;912;160;0;1072;168;0;0;168;24;15;C;54932
33444;0;0;9964;0;2787;0;0;1668;372;0;2040;168;0;0;168;52;36;G;103453
27;0;0;4;0;NA;0;0;1610;303;0;1913;168;0;0;168;52;37;F;99116
17376;0;0;2482;0;1287;0;0;2076;173;0;2249;173;0;0;173;52;15;N;63973
45124;0;0;6734;0;3136;0;0;1903;77;11;1991;163;0;0;163;52;10;G;155647
25445;0;0;1627;0;1862;0;129;1868;39;72;1979;168;0;0;168;52;17;C;17829
28209;0;0;5291;0;1915;61;0;1547;481;140;2168;117;52;5;174;52;33;H;152122
31880;30;0;6157;0;2346;143;0;1628;448;16;2092;175;1;8;184;52;18;C;107530
22166;0;0;2743;0;1562;130;0;1783;249;200;2232;148;12;14;174;52;20;M;175173
3330;0;0;100;0;3330;0;0;160;0;0;160;160;0;0;160;4;0;J;168278
92253;0;0;18991;0;7648;0;0;1936;208;0;2144;168;0;0;168;52;22;D;68308
43778;0;36308;2093;0;3023;0;0;15;1915;0;1930;0;160;0;160;52;52;Q;24454
32146;27963;620;3562;0;2595;523;0;1629;459;232;2320;140;28;14;182;52;33;C;33283
32056;0;0;1923;0;2468;0;0;1443;402;501;2346;122;36;0;158;52;39;Q;136508
33514;0;2152;2152;0;3518;0;0;1606;60;0;1666;163;0;0;163;52;24;Q;6905
20585;0;0;1400;0;1613;165;0;1692;399;76;2167;168;0;15;183;52;20;C;141702
18250;0;0;1332;0;1382;0;0;1744;351;56;2151;160;8;0;168;52;23;C;100762
33261;0;0;2772;0;2682;0;0;1533;218;58;1809;137;12;3;152;52;30;Q;21828
24119;0;0;3000;0;1966;125;0;1770;188;120;2078;170;1;10;181;52;25;H;69594
23386;0;0;2568;0;1613;10;0;1393;124;6;1523;128;2;6;136;52;15;C;91034
95534;585;413;20064;0;6209;1562;0;1875;168;212;2255;168;0;50;218;52;13;M;118121
14507;0;0;1233;0;649;0;0;1473;559;74;2106;91;76;0;167;52;17;C;113250
18269;0;0;1434;0;1446;45;0;1336;751;28;2115;118;50;4;172;52;47;C;146315
13350;0;0;3160;0;1581;587;72;1936;233;520;2689;177;0;51;228;52;23;N;99613
21747;0;1557;614;0;1631;33;0;1654;376;78;2108;163;10;3;176;52;20;F;3148
56959;1427;528;12443;0;3605;0;0;1497;423;147;2067;147;10;12;169;52;40;N;96599
23345;1210;0;2722;0;1259;35;105;1750;232;262;2244;118;32;4;154;52;19;N;102227
35635;0;0;17418;0;5384;0;0;688;16;0;704;168;0;0;168;20;0;C;74639
25117;0;0;6469;0;2129;0;0;1742;289;0;2031;157;11;0;168;52;34;H;177438
18546;0;0;1287;0;1343;55;0;1859;229;159;2247;168;0;6;174;52;20;C;125279
18756;0;937;4023;0;1366;0;0;489;1447;0;1936;0;168;0;168;49;1;R;131162
NA;0;0;2;0;10;0;0;1920;0;0;1920;160;0;0;160;52;20;N;74099
26662;0;0;3251;0;1972;174;0;1792;325;164;2281;160;8;13;181;52;28;C;27612
29845;0;0;587;0;2721;390;0;1621;512;247;2380;168;0;27;195;52;16;F;1659
23702;0;165;1363;0;1709;112;213;1668;204;117;1989;144;12;10;166;52;34;Q;184452
31024;1553;0;4713;0;2283;22;0;1519;208;65;1792;166;0;2;168;52;26;E;555
34645;0;2542;2731;0;2694;4;0;1636;444;113;2193;152;10;2;164;52;24;C;138599
23859;0;0;3354;0;1677;5;0;1766;362;40;2168;162;6;0;168;52;30;C;168123
24194;0;0;3254;0;1647;0;0;1732;353;3;2088;168;0;0;168;52;20;S;18290
26640;0;0;3600;0;2157;0;0;1667;334;9;2010;144;12;0;156;52;42;C;61700
10677;0;0;707;0;1414;0;0;1002;94;0;1096;150;18;0;168;26;12;F;64795
42339;0;0;6053;0;2865;0;0;1840;240;0;2080;168;0;0;168;52;24;F;16054
29381;0;0;1;0;2448;0;0;1796;280;0;2076;128;40;0;168;52;35;M;55669
34392;0;29040;5352;0;2535;0;0;1684;328;87;2099;122;49;12;183;52;34;Q;33581
41944;0;4168;13;0;3278;0;579;1528;227;19;1774;145;10;0;155;52;19;C;144353
52109;0;0;10717;0;2942;0;0;1960;90;136;2186;168;0;0;168;52;7;H;116689
28939;0;0;4134;0;2044;0;0;1645;219;0;1864;128;40;0;168;52;24;J;121472
25542;0;0;1328;0;2247;0;0;1751;328;0;2079;168;0;0;168;52;28;J;46409
20161;0;0;0;0;1720;50;0;1496;200;95;1791;140;16;4;160;52;21;F;2158
39960;0;0;5708;0;2721;0;0;1858;174;0;2032;168;0;0;168;52;19;C;8803
37103;0;0;2182;0;2878;0;132;1556;240;33;1829;150;6;0;156;52;32;Q;43656
43017;0;5074;13;0;3505;346;0;1788;244;202;2234;164;4;30;198;52;27;C;144341
61150;0;50517;10633;0;4584;0;0;1961;238;0;2199;183;4;0;187;52;33;Q;128667
8648;0;0;0;0;709;0;0;1295;193;0;1488;112;16;0;128;52;29;C;73230
36649;0;0;5235;0;3214;0;0;1844;132;8;1984;168;8;0;176;52;17;J;91341
34458;1201;0;9645;0;2331;12;0;1459;653;122;2234;153;32;1;186;52;25;G;178112
9860;0;510;0;0;863;0;0;1359;579;0;1938;160;0;0;160;52;29;C;1839
21318;0;0;3056;0;1648;0;0;1654;334;39;2027;161;0;0;161;52;20;C;30139
86175;0;0;9816;0;5728;0;0;1645;263;0;1908;158;0;0;158;52;35;K;133076
43805;0;0;2436;0;2436;0;0;1497;259;118;1874;131;14;13;158;52;26;M;186006
9154;0;0;734;0;1426;0;0;908;80;0;988;120;48;0;168;26;10;C;83301
11395;0;0;1407;0;NA;0;0;798;57;97;952;NA;NA;0;NA;37;8;Q;11819
24700;0;0;3435;0;1797;79;0;1520;497;56;2073;144;30;8;182;52;47;C;172656
NA;0;0;5621;0;3356;0;0;1680;291;0;1971;147;18;0;165;52;23;J;31195
22272;0;2160;3552;0;1839;0;0;1636;281;0;1917;154;4;0;158;52;23;K;51234
44014;0;2819;6125;0;2842;0;0;1747;341;0;2088;176;0;0;176;52;5;J;61410
37920;0;0;15767;0;1851;0;0;1789;227;0;2016;168;0;0;168;52;32;G;22504
33537;1879;0;2168;0;2423;95;0;1782;250;168;2200;160;8;6;174;52;30;C;178327
34172;0;0;5511;0;2398;0;0;1694;313;123;2130;154;7;9;170;52;32;E;80981
40568;0;0;6483;0;2659;377;0;1958;200;106;2264;216;0;17;233;52;17;C;112597
56899;0;0;12529;0;4019;0;0;1736;264;0;2000;176;0;0;176;52;19;C;124023
32953;0;766;4488;0;2746;890;0;1771;174;286;2231;161;0;63;224;52;26;J;172576
29949;0;1000;3124;0;2338;0;0;1830;143;0;1973;158;6;0;164;52;15;Q;136185
11985;0;0;924;0;897;0;0;1544;24;0;1568;168;0;0;168;52;104;E;13509
26700;0;0;2048;0;2030;0;0;1680;230;0;1910;155;3;0;158;52;19;K;76486
21009;507;0;3506;0;1409;47;0;1759;329;86;2174;154;22;5;181;52;31;M;54242
18697;151;0;720;0;2269;0;0;1442;617;0;2059;168;0;0;168;47;30;F;89293
5625;0;0;1529;0;NA;0;0;1459;0;0;1459;138;0;0;138;52;0;I;81032
44681;0;0;3360;0;NA;0;0;NA;NA;NA;NA;NA;NA;0;NA;0;0;K;123388
44998;0;0;4805;0;3163;0;0;1652;319;0;1971;158;1;0;159;52;37;C;71264
30897;0;0;4527;0;2200;0;0;1670;241;13;1924;157;0;0;157;52;21;K;53291
17082;0;0;2;0;1424;0;0;1468;0;0;1468;160;0;0;160;52;192;C;22007
14662;0;2057;2539;0;1447;0;0;1365;669;0;2034;148;20;0;168;52;14;G;83542
24828;0;0;3437;0;1739;0;0;1596;440;0;2036;107;56;0;163;52;35;G;112688
36706;0;0;4772;0;2589;0;0;1810;206;0;2016;136;32;0;168;52;20;R;54073
84228;2281;0;10294;0;5352;0;0;1777;204;0;1981;168;0;0;168;52;23;K;146333
35962;0;8084;2325;0;2650;17;64;1333;634;110;2077;140;24;1;165;52;21;C;23506
23149;0;0;3244;0;1689;0;0;1662;379;0;2041;163;5;0;168;52;35;N;91994
64919;0;0;3087;0;4993;0;0;1555;0;0;1555;156;0;0;156;52;34;R;82518
30743;0;192;4686;0;2031;46;0;1722;318;124;2164;173;4;18;195;52;23;E;69416
12720;0;0;1187;0;960;0;0;1228;541;0;1769;138;2;0;140;52;21;C;54190
23362;0;0;3150;0;1687;0;91;1608;168;0;1776;136;32;0;168;52;30;G;157411
68950;0;0;17642;0;4277;0;0;1592;222;0;1814;140;13;0;153;52;5;K;130694
21710;0;0;1656;0;1679;0;0;1728;144;74;1946;144;0;8;152;52;28;Q;44874
28662;0;0;4375;0;2027;0;0;1738;252;8;1998;167;0;1;168;52;30;G;177456
26229;0;0;1890;0;2171;248;0;1828;221;86;2135;168;0;17;185;52;27;C;157361
28331;0;3531;1062;0;1865;123;0;1687;401;104;2192;168;0;8;176;52;36;C;116184
25364;156;0;4151;0;2706;0;0;1577;525;0;2102;168;0;0;168;48;11;F;89297
22350;0;0;3104;612;1552;0;0;1726;230;0;1956;163;0;0;163;52;28;R;9591
88000;0;0;13000;0;6285;0;0;1860;180;0;2040;176;0;0;176;52;15;C;18059
18302;0;0;1;0;1408;95;0;1920;200;108;2228;160;20;9;189;52;28;S;118944
23756;0;0;1655;0;1655;0;0;1784;248;60;2092;168;0;8;176;52;26;S;37076
24628;0;0;1673;0;1892;145;0;1416;402;27;1845;150;0;11;161;52;47;Q;43659
16061;0;0;1302;0;1374;0;0;1796;236;0;2032;165;3;0;168;52;21;N;36517
24881;0;0;2021;0;1974;0;0;1548;406;4;1958;144;20;0;164;52;28;C;14507
62466;0;5383;1135;0;2539;180;0;1700;340;0;2040;136;32;0;168;52;43;C;122742
41447;0;282;6013;0;2563;0;0;1635;402;0;2037;171;1;0;172;52;35;M;19922
26744;0;0;2675;0;2462;0;0;1312;479;0;1791;163;5;0;168;52;23;C;167329
21379;0;0;1601;0;1601;0;0;1945;278;0;2223;160;8;0;168;52;19;S;18304
28473;0;1044;3243;0;2096;0;100;1673;332;13;2018;151;12;0;163;52;28;C;155056
24632;0;0;13;0;1832;0;0;1817;207;42;2066;168;0;0;168;52;12;C;88406
26706;0;23354;3352;0;2523;0;216;1266;270;45;1581;156;0;6;162;52;31;Q;186038
31288;1062;0;4318;0;2159;0;0;1637;482;0;2119;127;41;0;168;52;31;N;147338
25251;0;0;2076;0;1988;0;0;1573;435;86;2094;144;24;0;168;52;22;F;37338
2371;0;1423;462;0;454;0;0;NA;2076;NA;NA;0;73;0;73;52;0;C;165474
21149;0;0;1817;0;1762;15;0;1876;128;15;2019;156;8;1;165;52;23;E;101355
17685;0;0;2472;0;1201;0;0;1743;270;19;2032;176;0;0;176;52;22;N;180719
23181;23181;0;4029;0;2028;0;0;1644;436;21;2101;174;0;0;174;52;15;G;7240
23789;0;0;1923;0;1874;28;0;1720;21;54;1795;167;1;12;180;52;16;M;75926
29458;0;0;5987;0;1941;108;0;1597;435;200;2232;144;24;8;176;52;40;C;146812
126360;0;116872;9488;0;9707;0;0;1776;264;0;2040;168;0;0;168;52;32;B;132329
33557;0;0;4747;0;2365;0;0;1720;432;0;2152;130;38;0;168;52;37;C;169812
27813;0;0;4262;0;1969;0;0;1741;356;0;2097;166;2;0;168;52;31;N;53128
17062;0;0;1276;0;1240;0;0;1920;112;8;2040;168;0;0;168;52;12;E;80577
143693;0;0;15340;0;10591;0;0;1680;233;0;1913;165;0;0;165;52;28;K;112088
33694;0;0;3720;0;2676;648;36;1567;253;420;2240;156;3;43;202;52;35;R;83274
30172;943;0;3080;0;2185;0;0;1491;380;14;1885;133;25;2;160;52;20;K;133610
30800;0;0;4400;0;2200;0;0;1848;192;0;2040;168;0;0;168;52;23;F;37569
54986;0;0;2;0;3500;430;0;1816;184;89;2089;188;0;20;208;52;21;G;178554
33558;1086;0;5019;0;2523;0;0;1728;414;22;2164;160;8;0;168;52;36;M;22497
94;0;0;16;0;NA;0;0;1880;152;0;2032;168;0;0;168;52;19;E;99095
19750;0;0;1494;0;1494;0;0;1645;410;7;2062;165;1;0;166;52;28;C;148115
19054;0;0;2722;0;1361;0;0;NA;NA;NA;NA;NA;NA;0;NA;52;41;N;41305
25755;0;0;5427;0;1374;0;0;1417;559;0;1976;115;49;0;164;52;21;C;139120
30582;0;0;2119;0;2391;0;0;1541;306;0;1847;161;0;0;161;52;36;Q;136460
49202;0;0;3656;0;2921;0;0;1688;360;73;2121;164;4;0;168;52;45;M;175377
13381;0;0;115;0;1256;0;0;1427;80;0;1507;168;0;0;168;39;1;C;37517
23930;0;20640;3290;0;1701;0;156;1431;409;11;1851;114;36;0;150;52;33;Q;33679
41319;0;0;5614;0;2927;0;0;1502;144;0;1646;160;8;0;168;52;18;M;71175
50008;2204;0;10806;0;3267;421;0;1800;240;242;2282;168;0;20;188;52;20;C;13079
47774;0;0;3651;0;3615;0;0;1740;348;0;2088;147;21;0;168;52;21;C;180193
38240;0;4676;5826;0;2596;38;431;1633;199;25;1857;158;0;6;164;52;15;C;121420
19487;0;0;1456;0;1728;0;270;1872;174;43;2089;150;6;0;156;52;29;Q;90868
22571;0;0;2;0;1608;0;0;1800;216;0;2016;161;7;0;168;52;33;M;44248
28813;0;1030;3044;0;2094;16;0;1708;396;18;2122;112;56;1;169;52;29;C;53036
20561;0;1847;1347;0;1601;163;0;1774;258;160;2192;152;16;16;184;52;17;S;134121
18051;0;0;214;0;1284;0;0;1827;261;0;2088;160;8;0;168;52;27;G;156517
21165;0;0;1449;0;1722;0;0;1296;0;0;1296;120;0;0;120;52;38;Q;151218
38990;0;0;6617;0;3268;0;0;1723;365;0;2088;116;52;0;168;52;14;C;129500
21506;0;490;1735;0;1412;0;0;1597;479;0;2076;137;36;0;173;52;21;C;3676
22648;0;0;786;0;1546;119;0;1832;308;76;2216;144;24;11;179;52;35;F;107110
35135;0;32115;2460;560;3029;0;0;1824;210;0;2034;169;44;0;213;52;26;C;181395
26453;0;24806;1647;0;2125;0;208;1471;357;102;1930;151;0;13;164;52;39;Q;174851
41514;0;1947;1918;0;3331;73;0;1751;48;60;1859;158;0;5;163;52;20;H;124322
19970;0;0;2514;0;1443;175;0;1366;450;125;1941;160;8;16;184;52;20;C;73580
33882;0;0;4492;0;1919;51;111;1718;268;30;2016;156;12;7;175;52;32;C;151535
20370;0;0;2695;0;1405;25;0;1784;221;104;2109;173;7;2;182;52;26;N;110749
26414;0;0;2305;0;1877;0;0;1249;444;27;1720;134;30;0;164;52;25;Q;153930
18528;0;0;1477;0;1515;0;0;1900;80;0;1980;165;7;0;172;52;12;C;1451
11291;0;0;1775;0;NA;0;0;306;156;0;462;NA;NA;0;NA;13;26;E;95629
33267;0;0;2833;0;2498;0;564;1691;202;9;1902;157;0;0;157;52;27;H;43262
20820;0;0;3317;0;1589;0;0;1714;262;0;1976;168;0;0;168;52;22;C;151968
26571;0;0;4600;0;1996;0;0;1776;264;0;2040;168;0;0;168;52;27;J;130473
47641;0;0;1915;0;3362;0;0;1628;193;0;1821;150;0;0;150;51;26;M;184606
40750;0;36494;4256;0;3202;1450;0;1469;192;832;2493;133;2;79;214;52;24;C;37103
34370;0;0;1530;0;3400;808;0;1252;619;518;2389;160;8;71;239;52;71;N;157915
33846;0;0;4540;0;2269;147;0;1728;420;127;2275;136;36;9;181;52;32;F;152126
19910;0;17093;2817;0;1419;0;0;1704;328;0;2032;168;0;0;168;52;37;N;163221
35961;0;0;3889;0;2314;169;0;2055;55;339;2449;150;0;39;189;52;19;C;42774
23744;0;0;1696;0;1696;0;0;1680;0;0;1680;140;0;0;140;52;15;H;38836
45031;0;0;5931;0;2990;0;0;1812;248;0;2060;168;0;0;168;52;26;K;36055
31942;0;0;4277;0;2601;180;54;1630;256;168;2054;100;57;0;157;52;31;H;31098
31901;0;0;4557;0;2279;68;0;1628;232;36;1896;148;0;5;153;52;29;K;18406
NA;0;0;0;0;4388;580;0;NA;NA;NA;NA;189;0;25;214;0;0;J;183558
37618;0;0;2541;0;3509;0;119;1566;286;0;1852;132;20;0;152;52;33;Q;150401
14823;0;0;559;0;1176;0;0;1786;48;40;1874;147;0;0;147;51;20;H;83121
55078;635;13581;4304;0;4385;65;447;1339;0;58;1397;132;0;4;136;52;50;R;160339
29988;0;25684;4304;0;2162;377;0;1699;333;295;2327;160;8;27;195;52;36;C;36937
43945;0;0;4883;0;2833;0;0;1574;332;55;1961;148;9;3;160;52;27;K;102380
19660;0;0;1543;0;1543;0;0;1592;429;19;2040;118;35;0;153;52;166;Q;176829
33031;0;0;0;0;2631;0;0;2080;0;0;2080;173;0;0;173;4;22;C;32169
14399;0;0;1;0;2579;0;0;1592;0;0;1592;240;0;0;240;28;0;H;57007
21678;0;0;2704;0;1593;178;0;1720;196;288;2204;125;38;19;182;52;19;G;111823
27952;0;0;3993;0;1957;0;0;1904;128;0;2032;144;24;0;168;52;16;C;8948
30530;0;0;3302;0;2241;110;0;1699;305;121;2125;167;3;8;178;52;33;D;133703
23951;0;0;1930;0;1929;0;0;1782;297;1;2080;143;24;0;167;52;26;C;14477
29120;0;0;1864;0;2403;99;260;1804;456;53;2313;168;0;6;174;52;19;C;148408
34817;0;738;5733;0;2183;39;251;1662;367;108;2137;160;8;4;172;52;44;C;142416
16755;0;0;2779;0;1352;0;79;1442;232;0;1674;146;0;0;146;52;20;G;6749
18469;0;0;1050;0;1865;90;0;1496;96;139;1731;155;16;8;179;52;12;G;121244
42507;0;0;3666;0;5054;1268;0;1638;390;195;2223;160;4;65;229;52;32;C;62718
20483;0;0;1695;0;2228;0;0;1366;682;0;2048;168;0;0;168;52;25;C;52572
119884;2444;0;17483;0;7687;0;0;1876;204;0;2080;168;0;0;168;52;19;F;152804
15829;0;0;1192;0;1192;0;0;1720;320;0;2040;144;24;0;168;52;200;C;26341
26062;0;0;3330;0;1914;117;0;1569;254;76;1899;148;8;9;165;52;21;E;36379
19752;0;3198;1510;0;1531;59;118;1548;0;40;1588;156;0;5;161;52;26;Q;163840
38555;0;0;5178;0;2604;0;0;1775;258;0;2033;164;4;0;168;52;29;M;61032
28856;0;0;3866;0;2118;185;0;1840;240;159;2239;160;0;15;175;52;15;C;31145
30012;351;0;2218;0;2366;0;0;1745;295;0;2040;161;7;0;168;52;16;J;162950
6213;0;0;1920;0;1703;0;0;608;72;0;680;168;0;0;168;17;7;N;29668
18156;0;0;1294;0;1431;0;136;1811;212;107;2130;144;24;14;182;52;27;N;55395
NA;0;0;0;0;3149;0;0;NA;NA;NA;NA;176;0;0;176;0;0;J;183215
24154;0;127;2681;0;2359;0;0;1156;1268;0;2424;186;16;0;202;52;22;H;62522
18825;0;0;1883;0;1918;0;0;1436;484;0;1920;160;8;0;168;52;25;F;148686
37763;0;0;2974;0;2065;0;0;1908;188;297;2393;168;0;0;168;52;15;N;47679
49490;1182;1958;4240;0;3522;0;0;1631;241;0;1872;149;7;0;156;52;26;K;20509
50509;0;0;8813;0;3625;160;0;1741;247;71;2059;151;15;8;174;52;27;K;51532
16986;0;0;2340;0;1140;0;0;1694;347;14;2055;154;5;0;159;52;32;E;62075
19020;0;0;2903;0;1600;0;0;1724;633;72;2429;149;10;9;168;52;21;G;62665
32450;0;0;3890;0;2210;0;0;1744;344;13;2101;167;1;0;168;52;21;M;45364
26985;0;0;1929;0;1992;63;0;1614;655;23;2292;146;21;5;172;52;34;C;142583
18584;0;0;1;0;1430;5;0;1920;200;15;2135;160;20;1;181;52;28;S;118938
22612;0;0;2890;0;1572;0;0;1721;376;0;2097;169;15;0;184;46;18;I;66232
64371;0;0;5335;0;5244;0;0;1746;364;0;2110;174;8;0;182;52;36;H;119736
33405;0;0;3934;0;2413;386;99;1582;282;346;2210;150;6;26;182;52;29;E;51942
18062;0;0;1876;0;1603;0;0;1438;80;1;1519;152;0;0;152;49;16;F;16370
44713;0;0;2926;0;3451;500;236;1670;136;500;2306;144;0;71;215;52;17;C;168072
39562;0;5100;6644;0;2756;0;0;1640;413;0;2053;158;10;0;168;52;51;G;29974
26653;0;0;1971;0;1999;28;0;1864;168;22;2054;168;0;2;170;52;21;C;157366
28263;0;0;4829;0;1922;0;0;1647;335;4;1986;145;13;0;158;52;28;C;60059
21968;0;0;2484;0;1562;0;0;1578;198;0;1776;121;46;0;167;52;21;C;8096
24013;0;0;1847;0;1847;0;0;1709;322;10;2041;162;12;0;174;52;20;N;64845
16039;0;0;1828;0;1929;496;94;1975;245;176;2396;163;1;45;209;52;27;C;179969
37960;0;0;2920;0;2920;0;0;1670;369;0;2039;166;2;0;168;52;20;C;79442
22999;0;0;1416;0;1774;255;0;1757;283;323;2363;121;47;10;178;52;29;J;88320
30717;0;23366;1485;5642;2436;0;0;1160;192;0;1352;176;0;0;176;49;24;H;14469
30638;0;0;4196;0;2154;0;0;1699;428;0;2127;159;9;0;168;52;26;M;45499
112306;0;0;6189;0;NA;0;0;1740;308;0;2048;168;0;0;168;52;38;C;103380
22098;0;0;1938;0;1680;0;0;1103;162;0;1265;100;0;0;100;52;20;J;18438
26375;0;1666;2643;0;2342;13;0;1672;359;64;2095;168;0;1;169;52;22;C;34631
21023;0;0;1509;0;1479;0;0;1643;396;101;2140;159;9;0;168;52;19;C;109506
22371;0;0;2979;0;1542;0;53;1705;276;37;2018;120;38;0;158;52;28;G;60834
27614;0;0;1938;0;1939;0;0;1631;456;79;2166;148;20;0;168;52;23;C;180703
13057;0;0;1004;0;1392;0;0;1039;0;0;1039;0;168;0;168;52;30;C;137367
6471;0;0;0;0;1198;0;0;680;0;0;680;173;0;0;173;0;0;S;143491
45619;0;0;5003;0;3077;10;0;1777;255;68;2100;158;2;1;161;52;31;C;153227
28586;1077;23756;3753;0;2124;0;0;1548;230;42;1820;150;0;4;154;52;30;Q;131306
7213;0;0;399;0;1685;405;0;652;0;174;826;173;0;45;218;17;0;N;77564
19603;0;0;1529;0;1410;0;0;1400;0;0;1400;135;0;0;135;52;20;C;176231
28789;0;0;3424;0;2081;0;0;1662;361;0;2023;160;8;0;168;52;24;M;74864
10879;0;0;881;0;1533;0;14;1127;6;18;1151;168;6;0;174;32;1;G;90914
31634;0;0;3049;0;2523;203;0;1470;502;83;2055;174;12;13;199;52;41;Q;130062
25433;0;0;400;0;1735;133;0;1814;218;38;2070;112;56;12;180;52;27;F;107107
19287;0;0;2736;0;1377;0;0;1852;180;0;2032;152;16;0;168;52;23;G;150364
15573;0;0;1247;0;1212;0;0;1912;128;0;2040;168;0;0;168;52;15;S;64833
50537;0;0;4834;0;3762;0;0;1592;339;0;1931;144;15;0;159;52;30;J;78752
21437;0;0;2837;0;1619;116;0;1836;235;104;2175;168;0;12;180;52;23;G;157022
39187;0;0;3560;0;2539;0;0;1780;157;0;1937;156;3;0;159;52;26;G;166169
27464;0;0;1879;0;2164;0;0;1501;531;16;2048;167;0;0;167;52;19;C;79393
32384;910;0;4060;0;2245;0;0;1564;437;61;2062;150;7;0;157;52;23;K;100212
20989;0;0;7665;0;1940;0;0;1704;174;54;1932;150;6;0;156;50;29;Q;85080
35833;0;5302;7987;0;2370;0;195;1563;282;4;1849;111;42;0;153;52;40;C;4307
26955;0;0;2084;0;2043;0;0;1748;396;0;2144;160;8;0;168;52;21;C;141667
59714;0;0;59714;0;4319;0;0;2076;0;0;2076;173;0;0;173;0;0;F;161467
20043;0;0;3340;0;1670;0;0;1823;262;18;2103;160;10;0;170;52;21;I;120723
23670;478;0;6135;0;2050;190;80;1861;240;242;2343;126;48;20;194;52;24;R;92803
31082;0;0;2055;0;2230;0;0;1577;670;0;2247;151;0;0;151;52;32;Q;148124
27722;0;0;1238;0;2041;100;0;1766;200;225;2191;129;48;10;187;52;13;C;1345
36128;0;33465;2663;0;2103;453;83;1967;224;792;2983;140;42;47;229;52;24;N;161888
25326;0;0;2489;0;1913;0;0;1692;118;0;1810;156;8;0;164;52;26;Q;76432
26690;0;0;3133;0;2009;115;423;1652;345;59;2056;163;1;0;164;52;17;C;164842
50193;0;0;5680;0;2840;0;0;1688;344;0;2032;156;12;0;168;52;39;J;16540
33181;0;0;3564;0;2501;635;49;1778;254;289;2321;168;0;42;210;52;32;C;182224
42396;2365;0;10231;0;2749;0;0;1760;264;0;2024;168;0;0;168;52;19;C;36975
30684;0;0;3863;0;2206;240;0;1598;266;229;2093;114;36;16;166;52;24;E;9526
12280;0;0;1098;0;1403;0;0;1058;335;0;1393;120;48;0;168;38;32;C;122182
65647;0;0;5000;0;4675;0;0;1928;206;0;2134;168;0;0;168;52;25;C;3885
57699;0;0;6716;0;3870;0;0;1646;280;0;1926;159;0;0;159;52;24;J;140146
17082;0;0;2;0;1424;0;0;1468;0;0;1468;160;0;0;160;52;192;C;22017
35000;0;0;11000;0;2000;50;0;1680;190;20;1890;140;10;1;151;52;26;G;154951
22819;0;0;2304;0;1645;0;0;1670;405;67;2142;159;9;0;168;52;29;C;94248
18593;0;0;1399;0;1550;0;0;1418;244;19;1681;156;0;0;156;52;21;C;3638
37903;0;0;1839;0;3525;1215;0;1482;347;408;2237;132;24;34;190;52;17;Q;127573
33646;0;0;1844;0;2263;185;285;1408;624;216;2248;112;56;14;182;52;20;F;21191
63603;0;0;12662;0;3696;0;0;1787;173;0;1960;114;48;0;162;52;15;C;165595
35678;0;0;4117;0;2490;49;206;1704;341;50;2095;144;24;3;171;52;39;C;112056
27688;429;0;4011;0;1708;0;0;1390;530;0;1920;138;12;0;150;52;23;N;82642
15430;0;0;2617;0;1419;83;0;1764;280;48;2092;168;0;7;175;52;29;H;34519
27907;0;0;4777;0;2186;0;0;1624;290;0;1914;159;0;0;159;52;25;J;140202
22794;0;0;4744;0;1537;18;52;1712;271;51;2034;139;26;2;167;52;22;G;58616
17748;0;0;2958;0;1479;0;0;2016;190;37;2243;168;0;0;168;52;190;G;116823
33759;0;0;2450;0;2604;409;133;1549;246;282;2077;147;6;21;174;52;35;Q;43220
35565;206;0;3214;0;2455;0;0;1504;234;71;1809;150;7;0;157;52;39;Q;25733
62142;790;45953;15399;0;3883;0;0;1393;295;0;1688;106;0;47;153;52;26;K;185133
26321;0;0;2049;0;2101;0;0;1647;264;9;1920;128;30;0;158;52;22;K;82918
48523;0;0;1490;0;4240;0;0;1825;191;0;2016;168;0;0;168;52;12;H;162887
21133;0;0;2689;0;1604;0;0;1578;401;0;1979;149;10;0;159;52;39;C;129344
14484;0;13402;1082;0;2004;0;0;957;151;2;1110;123;50;0;173;27;21;Q;24418
47017;0;0;7192;0;3223;0;458;1648;380;75;2103;133;29;0;162;52;17;D;64027
17147;0;0;1543;0;1036;0;0;1504;264;0;1768;104;16;0;120;52;21;B;159353
20405;0;0;1396;0;1377;0;0;2016;0;0;2016;168;0;0;168;52;22;G;158939
40356;0;0;3123;0;2800;0;0;1680;373;0;2053;160;8;0;168;52;37;M;175392
NA;0;0;212;0;1682;311;0;488;23;101;612;168;0;31;199;13;23;N;57716
21215;0;1709;311;0;1190;0;0;1608;460;0;2068;22;88;0;110;51;24;C;160024
28049;0;25937;2112;0;2162;0;0;1563;285;1;1849;118;36;0;154;52;26;Q;84485
20080;0;0;1604;0;1791;0;0;1604;144;0;1748;168;0;0;168;52;18;C;6961
27158;0;0;2090;0;2427;0;0;1816;0;0;1816;168;0;0;168;52;20;G;126134
24979;0;0;1801;0;1801;0;0;1915;152;0;2067;168;0;0;168;52;14;C;48344
21128;0;1946;2950;0;2413;0;0;1228;520;3;1751;129;5;0;134;52;30;Q;66295
42293;0;0;4193;0;4193;0;0;1666;300;0;1966;168;0;0;168;52;37;C;122003
26413;0;2174;2346;0;1773;16;77;1272;95;247;1614;125;105;1;231;52;10;B;106666
5172;0;0;354;0;1498;30;0;518;31;20;569;155;8;4;167;14;0;C;152026
15818;0;1218;1218;0;1265;0;0;1531;486;10;2027;160;5;0;165;52;45;S;134882
23457;0;0;3146;0;2026;0;0;1600;0;0;1600;160;0;0;160;52;26;C;112358
22000;0;0;2;0;1534;0;0;1727;314;0;2041;163;0;0;163;52;35;C;122143
NA;0;0;0;0;1473;0;63;NA;NA;NA;NA;160;8;0;168;0;0;G;27213
24658;0;0;2404;0;1702;0;0;1088;810;0;1898;124;44;0;168;52;20;C;37827
49007;0;0;7001;0;3500;0;0;2028;0;0;2028;169;0;0;169;52;30;H;101535
28383;0;24001;4382;0;2173;0;320;1635;246;15;1896;175;0;0;175;52;37;Q;138202
23952;0;0;1630;0;2001;372;0;1907;125;245;2277;169;0;32;201;52;14;C;81012
17850;0;1354;113;0;1189;0;0;1586;363;1;1950;124;44;0;168;52;17;C;85540
16069;0;0;2162;0;1075;0;99;1988;196;0;2184;140;42;0;182;52;19;N;89398
27308;0;20515;5325;0;2572;290;0;1494;424;250;2168;106;53;18;177;52;38;D;48395
24038;0;117;3069;0;1844;0;0;1337;654;13;2004;153;16;0;169;52;39;C;32003
30916;0;0;4138;0;2098;0;0;1481;535;85;2101;172;16;9;197;52;15;K;15763
33067;0;0;2403;0;2403;0;0;1640;448;0;2088;127;41;0;168;52;31;J;35238
28911;1860;0;3528;0;2252;0;0;1346;480;6;1832;131;19;0;150;52;32;I;88173
36048;0;0;4326;0;2596;0;0;1633;317;0;1950;128;22;0;150;52;27;G;118131
25181;0;0;3895;0;1781;149;0;1727;349;8;2084;158;2;8;168;52;35;C;124621
35936;0;0;6345;0;2395;22;0;1681;288;41;2010;166;4;2;172;52;24;S;81502
24803;0;0;1969;0;1971;0;0;1625;295;0;1920;152;8;0;160;0;17;C;172874
33665;0;30234;3306;0;2296;0;110;1643;216;4;1863;165;14;2;181;52;25;Q;24366
30813;0;0;2566;0;2148;13;0;1835;207;1;2043;160;8;0;168;52;23;C;91762
17934;0;0;2556;0;1209;0;61;1524;445;6;1975;131;38;0;169;52;19;Q;64965
21008;0;0;2222;0;1667;0;0;1638;242;0;1880;144;32;0;176;48;30;M;166062
5546;0;0;361;0;1498;0;0;544;32;0;576;168;0;0;168;15;2;H;84213
7247;0;0;612;0;1835;0;0;544;40;0;584;165;3;0;168;17;1;E;38797
28073;0;0;1801;0;2296;141;0;1694;432;126;2252;127;6;10;143;52;28;Q;137849
42826;0;0;6118;0;3059;0;0;1776;185;0;1961;148;0;0;148;52;30;K;176308
22422;0;558;1682;0;1692;0;0;1683;250;15;1948;136;40;0;176;52;15;C;84126
23165;0;0;1750;0;2338;232;0;1743;201;137;2081;160;8;17;185;52;25;B;179818
21703;0;0;2958;0;1489;0;0;1705;292;0;1997;158;0;0;158;52;28;M;32619
60360;0;0;6068;0;3034;0;0;1658;381;0;2039;120;48;0;168;52;32;C;39171
22834;0;0;3262;0;1631;145;0;2006;74;23;2103;168;8;13;189;52;8;M;58903
107776;0;42314;8298;0;7727;0;0;1291;342;0;1633;124;0;0;124;52;49;Q;154852
35371;0;2208;4626;0;2729;233;0;1898;118;23;2039;168;0;13;181;52;2;J;95112
20654;0;0;1458;0;1498;0;0;1759;257;0;2016;168;0;0;168;52;24;C;168220
35241;0;0;5299;0;2942;529;0;1588;306;135;2029;114;45;21;180;52;30;D;76316
36322;0;427;5171;0;2373;0;0;1772;268;12;2052;144;24;0;168;52;32;L;19236
29015;0;27;2537;0;2207;0;0;1401;459;0;1860;138;22;0;160;52;26;K;66186
19419;0;0;1383;0;1383;0;0;1650;280;0;1930;152;0;0;152;52;28;Q;151666
41071;0;0;5284;0;2642;0;0;2016;0;0;2016;168;0;0;168;52;21;C;103744
21373;0;0;1879;0;1531;0;0;1463;330;0;1793;144;0;0;144;52;38;Q;4487
13992;0;0;2495;0;1933;0;0;1696;320;0;2016;176;8;0;184;52;29;H;34497
20112;0;0;3106;0;2048;76;0;1696;392;3;2091;166;0;3;169;52;33;C;106865
21039;0;0;2460;0;1476;0;8;1754;286;0;2040;168;8;0;176;52;35;H;62699
17082;0;0;2;0;1424;0;0;1468;0;0;1468;160;0;0;160;52;192;C;22008
27328;0;0;2;0;2620;0;0;1640;367;195;2202;160;0;0;160;52;27;F;46546
30038;0;0;2177;0;2302;0;0;1604;235;0;1839;150;8;0;158;52;31;Q;100171
27866;0;0;3206;0;2087;218;225;1840;216;107;2163;168;0;16;184;52;25;C;39045
18491;0;0;3121;0;1537;0;0;1461;42;1;1504;174;0;0;174;44;26;C;102194
62109;0;0;13761;0;3985;0;0;1772;76;9;1857;168;0;0;168;52;14;G;73829
30716;0;0;5284;0;2277;0;0;1697;213;68;1978;112;46;0;158;52;38;E;389
14986;0;0;1167;0;773;0;0;1495;247;38;1780;104;0;0;104;51;29;Q;140878
33277;0;0;4200;0;2109;2;0;1679;384;15;2078;150;17;1;168;52;39;C;112027
16982;0;1213;1213;0;1213;0;20;1664;238;67;1969;141;20;0;161;52;34;Q;173164
30069;0;0;4056;0;2164;0;0;1681;288;0;1969;121;56;0;177;52;36;H;92041
28526;0;0;3970;0;2391;477;140;1830;185;129;2144;164;0;32;196;52;12;C;108233
31408;0;0;2416;0;2416;0;0;1822;266;0;2088;167;1;0;168;52;28;C;165909
21200;0;0;1622;0;1645;11;0;1598;476;10;2084;144;24;1;169;52;17;C;144055
20354;0;0;1694;0;1356;0;84;1804;176;74;2054;165;9;0;174;52;154;R;71315
36326;0;131;2360;0;2852;0;189;1635;258;0;1893;156;0;0;156;52;43;Q;168790
23618;0;0;1946;0;3327;1521;0;1406;312;359;2077;158;0;31;189;52;15;H;17856
57595;0;0;7249;0;3642;0;0;1692;184;0;1876;146;14;0;160;52;28;G;25454
23722;0;0;2221;0;NA;0;0;1809;295;0;2104;158;10;0;168;52;14;C;81074
136896;0;0;18800;0;9400;0;0;1752;328;0;2080;176;0;0;176;52;35;C;125624
19953;0;0;2312;0;1468;0;0;1380;660;0;2040;168;0;0;168;52;49;G;62199
32900;0;0;1;0;2146;156;0;1600;400;100;2100;150;26;16;192;52;33;C;147702
16334;0;0;2233;0;1645;0;220;1733;356;12;2101;160;8;0;168;52;37;C;170423
17462;0;0;1249;0;1249;0;0;1631;228;0;1859;154;5;0;159;52;21;S;46811
17557;0;1268;0;0;1319;87;0;1760;312;117;2189;168;0;9;177;52;20;C;56698
44618;0;0;0;0;2772;0;0;1699;342;70;2111;159;9;10;178;52;43;C;35854
77471;0;70698;6773;0;5957;38;0;1658;335;36;2029;164;0;1;165;52;42;Q;93300
16293;0;0;879;0;1261;0;0;1735;0;0;1735;167;0;0;167;52;28;C;148090
41519;0;0;2938;0;3176;140;0;1593;385;0;1978;158;11;8;177;52;28;J;55594
45693;0;1297;7417;0;3047;0;0;1848;240;0;2088;160;8;0;168;52;20;C;176394
23674;7308;0;1332;0;1875;0;0;1664;328;0;1992;104;64;0;168;52;30;C;77334
11987;0;0;2436;0;1328;47;0;1149;963;36;2148;174;0;5;179;52;17;N;130978
20302;0;0;1562;0;2448;0;0;1277;382;0;1659;164;0;0;164;52;32;C;90646
24145;0;0;3332;0;1588;0;0;1653;344;11;2008;156;0;0;156;52;13;N;41454
33430;0;0;2046;0;2555;0;0;1592;228;0;1820;100;48;0;148;52;38;Q;100165
24010;0;0;2878;0;1781;342;0;1764;267;106;2137;163;5;32;200;52;16;C;91144
18920;0;0;3275;0;486;0;0;727;37;0;764;NA;NA;0;NA;48;5;K;39351
35660;0;0;3684;0;2666;0;0;1559;230;0;1789;112;15;0;127;52;25;K;160625
45114;0;0;8540;0;3922;0;0;1456;0;205;1661;30;0;7;37;0;25;K;70448
50489;0;0;11607;0;4357;0;0;682;0;265;947;60;0;0;60;0;27;K;70015
29500;0;0;4398;0;2199;0;0;1523;209;26;1758;106;60;0;166;52;26;C;62600
26456;0;0;1657;0;1916;0;0;1602;234;22;1858;126;27;4;157;52;28;Q;26501
28275;0;617;4411;0;2323;0;0;1783;274;27;2084;152;8;0;160;52;26;C;28755
33217;0;0;5741;0;2168;7;0;1663;425;55;2143;112;56;1;169;52;19;C;106403
19783;0;0;2948;0;1322;0;0;1776;209;0;1985;128;39;0;167;52;21;H;77470
53242;0;44320;7930;0;3982;0;0;1759;239;0;1998;158;0;0;158;52;23;D;95266
50800;922;34740;8584;0;3933;933;0;1667;339;206;2212;160;0;26;186;52;20;M;38552
31341;0;0;5439;0;2237;244;0;1839;201;224;2264;168;0;20;188;52;25;G;62205
22776;0;0;1572;0;1949;353;0;1666;358;154;2178;161;7;26;194;52;23;F;47289
20997;0;0;2918;0;1468;0;0;1893;140;0;2033;173;0;0;173;52;21;G;27906
4580;0;1405;1405;0;1405;0;0;1424;210;0;1634;120;40;0;160;40;26;C;65024
4510;0;0;0;0;1228;0;0;514;32;0;546;0;168;0;168;21;4;G;155456
26024;0;0;3413;0;1897;158;0;1757;213;126;2096;163;3;12;178;52;23;G;7225
23283;0;0;2816;0;1686;277;0;2008;287;189;2484;165;3;24;192;52;18;C;163342
33028;0;27643;5385;0;2449;0;0;1490;302;0;1792;133;7;0;140;52;33;Q;128687
24934;0;0;2904;0;2066;22;0;1745;319;11;2075;168;0;2;170;52;22;I;166783
42429;0;39864;2565;0;2986;0;0;1640;300;54;1994;151;18;0;169;52;47;Q;136981
16230;0;0;1416;0;1975;159;0;1258;42;111;1411;129;33;21;183;39;5;C;152069
30054;0;0;6110;0;2058;160;0;1445;216;162;1823;160;18;14;192;52;20;C;111032
26284;0;0;3650;0;1832;0;0;1792;239;36;2067;160;0;0;160;52;20;C;16744
25840;0;0;3685;0;2187;0;0;1427;301;0;1728;147;4;0;151;51;23;N;37396
29241;0;63;1486;0;2348;18;0;1712;344;24;2080;148;0;5;153;52;0;C;110309
27337;0;0;2015;0;2336;198;0;1770;318;101;2189;168;0;13;181;52;20;C;50210
141042;209;0;35265;0;9010;0;0;1587;318;0;1905;150;7;0;157;52;26;K;97428
14796;0;0;1200;0;1985;125;0;1771;305;96;2172;173;16;9;198;52;32;C;90276
41073;325;0;6053;0;3002;257;0;1625;400;53;2078;132;36;12;180;52;50;G;50328
22646;0;1514;658;0;1762;100;0;1694;438;88;2220;168;0;9;177;52;37;C;155577
27525;0;0;4184;0;2191;208;93;1732;170;104;2006;156;0;16;172;52;20;Q;62438
26932;0;0;3698;0;1182;0;0;1816;2076;0;3892;173;0;0;173;52;25;H;95930
36132;0;0;3191;0;2725;0;0;1644;260;0;1904;135;22;0;157;52;33;K;66750
37381;0;3815;6611;0;2341;0;0;1663;237;0;1900;154;0;0;154;52;31;C;179601
28262;0;0;3828;0;2071;133;0;1787;77;76;1940;166;4;10;180;52;29;N;131455
13795;0;0;1053;0;1054;0;0;2212;224;0;2436;195;8;0;203;52;24;S;90169
20670;0;0;1368;0;1533;50;134;1735;120;51;1906;159;6;5;170;52;19;Q;7727
45680;0;0;2049;0;3501;841;109;1799;263;55;2117;170;10;30;210;52;33;C;46072
26395;0;1576;1727;0;2119;0;184;1639;401;18;2058;136;32;0;168;52;39;C;149311
28161;0;0;1743;0;3512;1193;0;1638;245;122;2005;127;28;6;161;52;41;Q;184127
20621;0;1950;1586;0;1564;36;0;1690;337;31;2058;143;15;4;162;52;25;Q;115297
18587;0;0;1413;0;1413;0;0;1710;410;0;2120;160;8;0;168;43;40;C;129180
36973;1174;0;4001;0;2979;252;0;1678;234;163;2075;112;45;11;168;52;27;K;39348
25531;0;0;4474;0;1708;0;0;1680;409;0;2089;120;48;0;168;52;30;J;40866
35630;0;0;5290;0;2545;0;0;1768;264;12;2044;168;0;0;168;52;28;J;165972
40151;0;3808;13;0;3183;0;596;1568;196;2;1766;144;8;0;152;52;23;C;144356
34322;0;23882;10440;0;2980;551;311;1456;373;175;2004;151;0;39;190;52;45;Q;184774
20619;0;0;1644;0;1671;73;53;946;1050;10;2006;188;6;5;199;52;36;Q;84830
30174;0;0;2892;0;2342;21;0;1463;435;196;2094;113;45;2;160;52;31;K;52690
31333;0;119;3416;0;2463;0;132;1603;174;8;1785;149;6;0;155;52;29;Q;134504
54241;0;0;10122;0;3926;0;0;1814;308;0;2122;184;0;0;184;52;31;C;97638
21163;0;103;2343;0;1595;0;0;1549;448;0;1997;123;50;0;173;52;42;C;31614
23157;0;0;0;0;2124;0;53;1473;0;0;1473;168;0;0;168;52;32;Q;33823
19202;0;0;1695;0;1695;0;0;1778;298;0;2076;144;29;0;173;52;23;C;149633
33045;0;0;7764;0;5901;32;4;1746;236;116;2098;148;5;2;155;52;18;I;30586
2893;0;0;1087;0;648;0;0;0;2088;0;2088;NA;1680;0;NA;52;18;C;145403
18200;0;0;2000;0;1350;0;0;1797;234;0;2031;164;4;0;168;52;29;C;38092
25660;0;0;1760;0;2012;0;0;1515;517;16;2048;166;2;0;168;52;17;C;79397
25085;0;0;1;0;2194;0;0;1370;0;202;1572;86;0;0;86;41;0;R;24902
21423;0;0;3060;0;1468;0;0;1649;332;24;2005;134;40;1;175;52;15;G;107002
25707;0;0;2848;0;2090;245;40;1614;287;71;1972;150;8;16;174;52;32;C;59304
19193;0;0;1954;0;1731;138;0;1383;658;88;2129;152;16;12;180;52;21;C;89986
45913;0;0;5936;0;3208;0;0;1919;89;0;2008;131;37;0;168;52;34;G;67078
53174;0;0;9062;0;4475;1135;0;1976;112;209;2297;168;0;50;218;52;7;B;96932
16921;0;0;2876;0;1448;0;0;1756;380;0;2136;162;6;0;168;52;19;F;135908
25309;0;0;3100;0;1848;0;0;1687;250;0;1937;166;2;0;168;52;29;C;40331
21902;0;0;3075;0;1510;0;0;1712;412;84;2208;145;31;0;176;52;142;C;131166
29609;0;0;7572;0;1786;0;0;1711;273;20;2004;159;4;14;177;52;23;K;15990
24938;0;0;1923;0;1923;155;0;1549;30;26;1605;144;0;8;152;52;33;Q;127653
11525;0;0;0;0;NA;0;0;522;0;6;528;NA;NA;0;NA;14;0;J;84090
103126;0;0;5899;0;5050;0;0;1730;221;0;1951;158;0;0;158;52;26;N;47241
16304;0;0;2330;0;1165;0;0;1832;191;0;2023;158;10;0;168;52;16;M;145456
36000;0;0;1479;0;2308;0;0;1686;346;0;2032;126;42;0;168;52;22;C;88214
42540;0;0;12065;0;2559;0;0;1529;267;0;1796;151;1;0;152;52;20;K;112876
16476;0;0;1314;0;1314;0;256;1753;279;0;2032;173;0;0;173;52;25;C;113100
28177;0;0;3997;0;3336;80;0;1872;200;96;2168;128;0;6;134;52;24;G;76053
83779;0;0;0;0;8269;0;0;1665;256;0;1921;153;6;0;159;52;25;Q;84557
14465;0;0;1346;0;1110;0;0;1399;472;0;1871;133;35;0;168;52;18;C;91946
22164;0;0;0;0;1691;155;0;1837;251;95;2183;168;0;13;181;52;22;H;83422
75245;0;62448;12797;0;5165;0;0;1909;291;0;2200;149;25;0;174;52;38;Q;138402
26955;0;0;2244;0;2039;0;0;1739;393;0;2132;172;8;0;180;52;27;C;96606
25886;0;0;5017;0;1852;0;0;1872;168;0;2040;160;8;0;168;52;15;J;7775
17656;0;0;933;0;1443;0;0;1364;220;5;1589;135;1;0;136;40;25;C;91976
19752;0;0;2642;0;1321;0;0;1585;415;20;2020;126;42;0;168;52;23;S;13422
46039;0;0;2615;0;3242;365;0;1845;506;37;2388;168;0;16;184;52;20;C;160824
18756;0;0;1368;0;1387;0;0;1800;329;0;2129;160;8;0;168;51;19;C;1616
28922;0;0;3963;0;2211;0;3;1944;396;0;2340;182;13;0;195;52;30;H;141446
22928;0;2550;3930;0;1904;0;0;1663;457;0;2120;134;34;0;168;52;38;F;135897
6140;0;0;576;0;3342;807;0;287;0;67;354;160;0;36;196;8;0;J;82796
36841;0;0;8609;0;2861;67;60;1674;414;78;2166;168;0;13;181;52;36;C;178541
25160;0;0;1819;0;1914;95;0;1784;251;72;2107;163;5;7;175;52;40;G;128878
115179;1781;0;26074;0;7391;0;0;1366;534;72;1972;143;15;7;165;52;36;K;185015
42230;0;0;7805;1968;5852;450;0;1096;769;138;2003;154;4;22;180;52;17;K;135779
34032;0;0;3923;0;2464;181;0;1613;168;31;1812;144;0;12;156;52;19;Q;36333
19422;0;0;1494;0;1494;0;0;1574;452;0;2026;118;48;0;166;52;16;C;148092
21313;0;0;2917;0;1521;0;52;1670;350;24;2044;134;40;0;174;52;42;G;37766
51978;0;42748;3570;0;3962;0;89;1511;108;0;1619;148;0;0;148;52;15;M;184925
25946;0;0;103;0;2049;0;0;1755;205;8;1968;160;8;0;168;52;26;C;139538
22850;1150;3100;0;0;1550;0;0;1742;274;0;2016;164;4;0;168;52;34;J;27068
19992;0;0;1273;0;1552;179;0;1834;29;196;2059;168;0;19;187;52;19;C;70828
15216;0;0;1203;0;1130;0;0;1600;341;NA;NA;163;0;0;163;52;24;C;123372
37946;0;0;7482;0;2220;66;0;1892;136;204;2232;156;13;7;176;52;21;H;152121
17627;0;0;2933;0;1489;0;0;1893;115;98;2106;175;0;1;176;52;17;C;102200
NA;0;0;3029;0;1607;0;0;1475;215;0;1690;169;0;0;169;44;33;I;71425
21454;0;0;1700;0;2718;0;0;1730;346;0;2076;152;24;0;176;52;36;F;18720
58416;0;0;4195;0;4339;0;0;1952;285;122;2359;164;0;15;179;51;40;Q;101440
74226;0;0;7847;0;3946;0;0;1635;0;326;1961;150;0;0;150;4;22;M;92472
31336;0;0;2810;0;2306;0;636;1572;268;8;1848;147;13;0;160;51;28;C;122303
20636;0;0;2927;0;1367;0;0;1686;339;0;2025;117;51;0;168;52;25;I;162617
24926;0;0;3225;0;1869;245;0;1706;326;200;2232;136;32;22;190;52;37;G;116429
29907;0;4026;5486;0;2032;82;0;1647;326;86;2059;151;11;10;172;52;32;C;94842
17642;0;0;2940;0;1300;60;0;1597;214;130;1941;182;78;6;266;47;15;H;175593
32729;0;0;2500;0;NA;60;0;1558;305;103;1966;133;20;4;157;52;22;K;138789
43582;0;0;7427;0;2997;0;0;1531;372;12;1915;129;29;0;158;52;26;K;53597
12567;0;0;1776;0;1566;142;0;1534;259;303;2096;157;0;52;209;48;14;H;99662
37500;0;0;2385;0;2385;347;0;1648;257;258;2163;143;23;24;190;52;18;K;64576
38865;0;0;5315;0;2243;0;0;1638;253;0;1891;158;0;0;158;52;19;K;120368
46860;0;0;4563;0;2771;153;0;1672;176;16;1864;152;0;29;181;52;20;C;36851
21914;0;0;2020;0;1711;0;71;1434;438;0;1872;154;2;0;156;52;34;Q;134230
144676;388;0;18571;0;12024;0;0;1870;170;0;2040;170;0;0;170;52;25;N;94640
34772;0;0;2065;0;2599;340;0;1824;208;272;2304;168;0;21;189;52;25;C;139877
55238;0;48443;6795;0;3386;0;0;1749;332;13;2094;160;8;0;168;52;29;C;3373
NA;0;0;0;0;1718;0;0;NA;NA;NA;NA;172;1;0;173;52;0;C;140074
54494;0;0;4404;0;3817;0;0;2150;346;0;2496;148;28;0;176;52;10;J;116616
20920;0;0;2197;0;1754;0;0;1390;686;2;2078;126;47;0;173;52;24;C;149007
24426;0;0;2754;0;1759;0;0;1641;445;0;2086;159;9;0;168;52;38;C;59059
38238;0;0;4400;0;2258;60;0;1741;204;196;2141;166;0;8;174;52;22;C;42526
39081;0;5203;1;0;3503;574;97;1833;311;483;2627;168;0;43;211;52;22;F;153169
20846;0;0;2879;0;1489;28;0;1795;0;35;1830;171;0;2;173;52;34;G;12526
47208;0;0;2108;0;4230;50;0;1429;432;7;1868;216;50;2;268;52;52;Q;184656
25165;0;0;4170;0;1809;68;0;1552;379;35;1966;158;10;6;174;52;211;C;70936
19819;0;0;2261;0;1662;0;0;1562;514;4;2080;127;46;0;173;52;38;C;148988
71123;0;0;5471;0;5471;0;0;1976;0;0;1976;163;0;0;163;52;32;Q;140912
32206;0;0;9797;0;2012;0;0;1697;183;105;1985;151;0;0;151;52;25;H;31816
41395;0;1;2626;0;3067;304;0;1845;242;176;2263;184;0;16;200;52;24;C;2235
33866;0;539;2319;0;2521;0;0;1835;241;48;2124;197;2;0;199;52;32;Q;34692
47956;0;0;5657;0;3258;0;0;1815;265;0;2080;168;0;0;168;52;24;C;23740
37545;1023;1440;8188;0;2223;0;0;1463;467;5;1935;137;23;0;160;52;22;J;108684
25577;0;0;3326;0;1838;175;0;1700;268;157;2125;146;9;13;168;52;35;F;102459
28531;0;0;1618;0;2608;394;0;1633;502;296;2431;160;8;31;199;52;26;F;159133
21252;0;0;3036;0;1981;0;0;1682;288;168;2138;158;9;18;185;52;20;H;85570
29998;0;0;5962;0;1928;0;0;1511;308;0;1819;144;0;0;144;52;26;H;68764
57819;0;0;17811;0;3625;0;0;1614;348;0;1962;164;8;0;172;52;30;K;112886
32725;0;0;4300;0;2268;0;0;1585;372;497;2454;119;38;0;157;48;17;D;65161
17718;0;0;1555;0;1315;10;0;1475;601;15;2091;69;104;1;174;52;32;C;46992
23064;0;0;1200;0;1922;0;0;1936;100;0;2036;144;24;0;168;52;80;C;63514
19846;0;0;1714;0;1437;149;0;1818;290;209;2317;159;9;17;185;52;19;C;49661
61877;0;50240;11637;0;5316;0;0;1318;260;338;1916;117;7;31;155;52;39;Q;31867
25257;0;1610;1620;0;2160;91;75;1760;323;110;2193;167;1;7;175;51;22;C;156674
33029;0;0;5221;0;2400;542;0;1729;193;439;2361;157;5;39;201;52;25;E;50243
17818;0;16464;1354;0;1354;0;0;1832;256;0;2088;168;0;0;168;52;21;C;87491
26183;0;24455;1728;0;1947;0;0;1443;341;0;1784;150;0;0;150;52;35;Q;137023
26108;0;0;4831;0;1812;0;57;1557;422;0;1979;142;14;0;156;50;28;C;84210
32740;0;28262;4478;0;2108;0;329;1498;510;14;2022;134;34;0;168;52;56;C;3378
24587;0;0;1749;0;1756;0;0;1755;271;0;2026;168;0;0;168;52;33;C;46733
45066;0;5375;6270;0;2688;0;0;1340;744;0;2084;164;0;0;164;52;41;M;170911
38850;0;0;3751;0;3136;0;0;1638;213;0;1851;113;56;0;169;52;21;J;119418
39407;98;0;5490;0;2745;0;0;1596;209;22;1827;148;4;0;152;52;24;K;21850
76064;0;0;4915;0;5046;0;0;1720;230;0;1950;157;0;0;157;52;19;K;133675
77437;0;0;13872;0;5995;0;0;1608;0;44;1652;125;0;0;125;52;29;K;87299
32886;440;25935;6124;0;2199;0;0;1502;486;0;1988;138;22;0;160;52;24;D;43099
26693;0;0;1803;0;2183;0;0;1896;240;0;2136;168;8;0;176;52;18;F;102062
41348;0;0;5451;0;2755;0;0;1600;440;0;2040;160;8;0;168;52;21;N;176715
22883;0;0;2107;0;1821;360;0;1802;306;215;2323;155;13;33;201;52;18;C;49655
72984;0;62670;10314;0;5706;0;0;1609;348;0;1957;146;18;0;164;52;27;Q;186069
13303;0;0;1122;0;1102;0;0;1851;24;60;1935;158;0;0;158;52;3;S;14353
10157;8179;0;1978;0;NA;0;0;584;1264;8;1856;168;0;0;168;50;27;G;59442
24472;0;0;3496;0;1677;0;0;1748;158;72;1978;158;5;0;163;54;15;J;82837
19502;0;17065;2437;0;1399;0;0;1437;498;0;1935;135;24;0;159;52;35;C;102921
53162;0;0;4670;0;4581;0;0;1805;333;0;2138;151;20;0;171;52;25;H;120069
23755;0;0;1736;0;1710;0;0;1836;196;0;2032;168;0;0;168;52;22;C;2062
31163;0;0;1650;0;2433;28;3;1727;331;77;2135;131;36;20;187;52;28;Q;171697
26070;0;21747;4323;0;2807;0;485;1266;714;0;1980;123;52;0;175;52;29;C;22969
20695;20695;0;1734;98;1734;0;0;1805;271;0;2076;164;9;0;173;52;28;C;10952
32807;0;29199;3608;0;2420;0;276;1552;234;0;1786;160;0;0;160;52;37;Q;168908
37752;0;0;4820;0;2729;0;0;1506;384;0;1890;128;30;0;158;52;23;K;33826
18335;0;0;1540;0;1540;0;0;1776;312;0;2088;164;4;0;168;52;30;C;56336
15993;50;0;2790;0;1646;100;0;1369;671;41;2081;164;8;4;176;52;81;C;115539
22320;0;1474;0;0;1524;44;0;1765;0;182;1947;173;0;5;178;52;20;C;177129
15123;0;0;2214;0;638;10;0;1630;343;0;1973;155;0;1;156;52;29;K;90387
16122;0;0;783;0;1282;0;0;1611;184;0;1795;146;0;0;146;52;11;H;161536
37260;0;0;2866;0;2850;0;0;NA;NA;NA;NA;113;55;0;168;52;0;C;30603
26283;0;0;3413;0;1833;95;216;1847;322;81;2250;176;0;8;184;52;23;C;6690
18246;0;0;2993;0;1520;0;0;1716;180;0;1896;156;0;0;156;52;6;E;67941
45899;0;0;9661;0;3262;0;0;1671;291;3;1965;136;32;0;168;52;17;C;6452
95169;0;0;13445;0;6740;0;0;1699;223;0;1922;156;3;0;159;52;29;K;24754
25740;0;0;4085;0;2350;295;0;1806;226;144;2176;160;8;21;189;51;28;G;41102
70836;0;0;6686;0;5920;0;485;1407;285;109;1801;144;12;1;157;52;41;Q;151984
25243;0;0;3858;0;1806;0;0;1824;216;0;2040;168;0;0;168;52;22;M;131001
28185;0;0;2328;0;2167;0;0;1852;180;11;2043;168;0;0;168;52;23;C;60471
30436;0;0;4034;0;2133;262;0;2074;333;353;2760;137;37;25;199;52;26;H;147473
16944;0;0;1375;0;1094;0;44;1748;156;0;1904;141;0;0;141;52;26;Q;8296
32669;0;0;6526;0;3215;0;59;1773;299;125;2197;128;40;0;168;52;25;G;76076
35969;0;3289;2125;0;2234;0;0;1444;256;117;1817;119;33;3;155;52;27;R;173796
19583;0;0;1435;0;1484;69;0;1698;270;86;2054;141;23;7;171;52;33;Q;82944
45386;0;0;3691;0;2994;0;0;1584;464;0;2048;124;44;0;168;52;58;M;44139
21123;0;1476;984;0;1573;60;0;1795;244;28;2067;167;1;6;174;52;30;C;160403
34148;0;0;5812;0;2311;0;0;1761;351;0;2112;168;0;0;168;52;24;M;169308
41755;0;0;5082;0;3061;0;0;1630;320;0;1950;139;19;0;158;52;32;I;1186
46717;0;0;2985;0;3155;0;0;1696;254;39;1989;157;0;0;157;52;20;K;133668
19348;0;0;1756;0;1509;0;0;1556;446;39;2041;152;16;0;168;52;38;C;26521
15340;0;0;439;0;1228;0;0;1083;1253;0;2336;105;105;0;210;48;8;C;38478
34902;0;0;3290;0;2645;0;0;1668;258;79;2005;157;0;0;157;52;30;Q;93567
23451;0;20695;1973;0;1729;0;89;1554;294;24;1872;156;0;0;156;52;48;Q;137252
26446;0;0;2692;0;2284;0;0;1507;299;1;1807;146;18;0;164;52;41;Q;130054
24188;0;0;3337;0;1735;0;0;1800;0;5;1805;159;9;0;168;52;33;C;94116
18997;0;0;1598;0;3100;0;0;2100;374;0;2474;208;5;0;213;52;28;I;162843
60434;0;52722;7712;0;4663;0;320;1709;228;0;1937;154;6;0;160;52;28;Q;103167
17956;0;0;1323;0;1363;0;0;1677;411;0;2088;160;8;0;168;52;13;C;157889
35715;0;0;4511;0;2864;277;0;1757;275;207;2239;168;5;15;188;52;33;C;38991
15850;0;14768;1082;0;2249;0;145;1036;56;0;1092;121;41;0;162;30;7;Q;111636
24267;0;0;1761;0;1859;0;0;1625;172;0;1797;136;7;0;143;52;24;Q;125677
19264;176;0;1474;0;1474;0;0;1637;376;0;2013;124;44;0;168;52;19;J;68827
37451;0;0;7745;0;2510;60;0;1493;312;18;1823;168;8;3;179;52;26;C;57417
51738;815;14115;3828;0;4269;101;499;1504;0;6;1510;152;0;6;158;52;36;R;160350
46211;0;2000;6030;0;3049;0;0;1855;241;0;2096;164;8;0;172;52;23;N;140974
23994;0;0;3143;0;1633;22;0;1705;269;18;1992;143;17;2;162;52;24;K;15139
34214;0;0;6338;0;2575;201;0;1711;398;126;2235;160;31;12;203;52;35;G;72753
45436;2325;775;3224;0;3418;0;0;1765;268;0;2033;168;0;0;168;52;28;C;114456
14364;0;0;1;0;1282;0;0;1680;306;0;1986;144;20;0;164;51;29;C;92297
32287;174;0;4588;0;2294;332;332;1897;264;157;2318;179;32;22;233;52;33;C;140011
31980;0;655;4168;0;2277;0;640;1711;376;10;2097;152;16;0;168;52;33;C;164637
17575;0;0;2710;0;1391;0;0;1740;288;26;2054;152;20;0;172;52;37;G;46598
23166;0;0;1553;0;1918;310;59;1773;256;105;2134;112;56;24;192;52;26;H;40802
22749;0;0;3202;0;1723;0;0;1604;472;0;2076;165;3;0;168;52;20;C;164786
31903;0;0;3961;0;2031;0;0;1298;363;0;1661;149;11;0;160;52;19;C;7990
42397;0;0;6056;0;3028;0;0;1608;0;0;1608;128;0;0;128;52;28;C;147634
29520;0;0;2108;0;2108;0;0;1680;258;0;1938;174;23;0;197;52;39;M;184797
22131;0;0;1630;0;1796;80;210;1827;261;32;2120;168;0;8;176;52;21;E;89800
19649;0;0;6801;0;1365;90;0;1926;214;126;2266;168;0;8;176;52;10;M;41950
28482;0;5592;3508;0;1812;0;0;1827;205;294;2326;161;7;0;168;52;26;G;132474
25021;0;0;3153;0;1900;0;250;1450;350;0;1800;150;18;0;168;52;15;C;182544
28834;0;0;3964;0;2053;0;0;1625;207;11;1843;146;0;2;148;52;27;E;185208
28027;1109;0;3754;0;1877;0;0;1713;261;25;1999;131;25;0;156;52;25;H;169823
20901;0;0;1762;0;1742;0;0;1876;128;0;2004;156;8;0;164;52;26;D;101319
17943;0;0;2408;0;1549;0;78;1768;344;31;2143;168;0;0;168;52;25;N;19183
27083;0;0;1348;0;2315;0;0;12;2012;0;2024;0;168;0;168;52;15;N;168870
28184;1542;2224;2224;0;2091;0;0;1784;248;0;2032;168;0;0;168;52;31;C;45413
24875;0;0;4796;0;1739;0;0;1542;478;15;2035;115;53;0;168;52;36;C;49492
43107;0;1823;5285;0;3186;0;0;1681;185;37;1903;158;0;5;163;52;17;K;178113
20068;0;2289;3184;0;1832;0;0;1725;315;1;2041;167;1;0;168;52;27;C;162216
19251;0;0;2931;0;1180;154;0;1280;109;0;1389;111;0;14;125;52;17;M;28704
35641;0;0;5538;0;2410;221;0;1856;202;240;2298;174;0;15;189;52;20;J;53520
25000;0;0;1250;0;1800;0;0;1760;0;0;1760;160;0;0;160;52;20;C;29387
22182;0;0;3267;0;1448;12;0;1526;614;48;2188;144;24;1;169;52;36;C;169800
14502;0;0;1489;0;1374;0;62;1584;291;6;1881;168;0;0;168;49;22;Q;12234
25244;0;0;3467;0;1838;0;0;1723;330;1;2054;156;12;0;168;52;34;G;76861
18147;0;0;3300;0;1664;0;0;1979;0;0;1979;172;0;0;172;52;26;N;174462
25318;0;0;1774;0;2183;13;0;1572;291;41;1904;155;0;1;156;52;40;Q;177090
49123;0;0;5590;0;3181;0;0;1853;203;0;2056;163;5;0;168;52;6;C;173516
16048;0;0;2010;0;1238;0;0;1235;676;24;1935;118;48;0;166;52;34;C;184712
17679;0;0;2499;0;1249;0;0;1900;180;0;2080;152;16;0;168;52;2;M;142928
20479;0;2804;0;0;1357;0;0;1880;160;0;2040;168;0;0;168;52;10;G;72597
20189;0;0;1732;0;1832;0;0;1638;224;0;1862;160;8;0;168;48;20;C;153110
25798;0;0;2156;0;2502;0;0;1625;212;73;1910;148;4;0;152;52;23;C;151198
75450;2352;4968;7798;0;5138;0;0;1744;264;0;2008;160;8;0;168;52;16;C;30252
4786;0;0;388;0;1165;0;0;605;19;5;629;168;0;0;168;15;1;M;1752
58863;54388;0;4475;0;4475;0;0;1871;161;0;2032;168;0;0;168;52;20;C;80882
37925;16;2576;5498;0;3159;0;0;1776;204;0;1980;156;7;0;163;52;26;J;21933
21738;0;0;1811;0;1811;0;0;1882;0;0;1882;166;2;0;168;52;20;H;9224
25618;0;0;5833;0;1721;0;0;955;1077;0;2032;161;7;0;168;52;39;C;129186
34439;0;0;2461;0;2791;457;0;1926;132;136;2194;168;0;27;195;52;13;C;172219
14115;0;0;386;0;760;44;0;1636;117;189;1942;114;48;6;168;51;15;H;151898
25876;0;23900;1976;0;2223;0;278;1579;132;0;1711;166;0;0;166;48;16;C;150973
26048;0;0;2500;0;1784;0;0;1841;322;0;2163;147;7;0;154;52;22;E;146648
5393;0;0;593;0;1789;0;21;520;58;0;578;104;58;0;162;16;0;Q;89372
31326;0;0;1369;0;2641;0;202;1590;247;102;1939;139;30;0;169;52;29;Q;99056
3533;0;0;680;0;141;0;0;157;913;0;1070;8;160;0;168;28;13;M;152948
27798;0;0;0;0;3562;0;0;1856;176;0;2032;160;0;0;160;52;21;R;149240
23015;0;0;1430;0;2210;0;0;1694;760;0;2454;152;8;0;160;52;20;C;14555
28693;0;0;3610;0;2353;0;0;1564;511;0;2075;160;8;0;168;52;17;H;35836
18460;0;0;2855;0;1330;0;0;1872;232;0;2104;168;0;0;168;52;20;C;22733
21123;0;0;3250;0;1714;314;0;1748;181;121;2050;167;0;8;175;52;19;G;32454
